"protein_name"	"gene"
"Serpin B6"	"SERPINB6"
"Hepatoma-derived growth factor-related protein 3"	"HDGFRP3"
"Vigilin"	"HDLBP"
"40S ribosomal protein S9"	"RPS9"
"EH domain-containing protein 1;EH domain-containing protein 3"	"EHD1"
"Proteasome subunit alpha type;Proteasome subunit alpha type-2"	"PSMA2"
"Diablo homolog, mitochondrial"	"DIABLO"
"Large proline-rich protein BAG6"	"BAT3"
"Dystrophin"	"DMD"
"TATA-binding protein-associated factor 2N"	"TAF15"
"Nucleobindin-2;Nesfatin-1"	"NUCB2"
"Thioredoxin reductase 1, cytoplasmic"	"TXNRD1"
"Glutathione peroxidase;Phospholipid hydroperoxide glutathione peroxidase, mitochondrial"	"GPX4"
"Amino acid transporter;Excitatory amino acid transporter 1"	"SLC1A3"
"Neural cell adhesion molecule 1"	"NCAM1"
"Polyadenylate-binding protein 1;Polyadenylate-binding protein;Polyadenylate-binding protein 3"	"PABPC1"
"E3 ubiquitin-protein ligase UHRF1"	"UHRF1"
"UBX domain-containing protein 1"	"UBXN1"
"Vacuolar protein sorting-associated protein 45"	"VPS45"
"Beta-catenin-like protein 1"	"CTNNBL1"
"Signal peptidase complex subunit 2"	"SPCS2"
"Beta-hexosaminidase;Beta-hexosaminidase subunit alpha"	"HEXA"
"Heterogeneous nuclear ribonucleoprotein D-like"	"HNRNPDL"
"Proteasome subunit beta type-3"	"PSMB3"
"SRA stem-loop-interacting RNA-binding protein, mitochondrial"	"SLIRP"
"Glutathione peroxidase;Glutathione peroxidase 1"	"GPX1"
"40S ribosomal protein S24"	"RPS24"
"Myelin expression factor 2"	"MYEF2"
"Eukaryotic translation initiation factor 5B"	"EIF5B"
"Spectrin beta chain, non-erythrocytic 1"	"SPTBN1"
"C-Myc-binding protein"	"MYCBP"
"Protein kinase C-binding protein 1"	"ZMYND8"
"Clathrin heavy chain;Clathrin heavy chain 1"	"CLTC"
"Single-stranded DNA-binding protein 2;Single-stranded DNA-binding protein 3"	"SSBP3"
"Methyl-CpG-binding protein 2"	"MECP2"
"Endophilin-B1"	"SH3GLB1"
"Nodal modulator 1;Nodal modulator 3;Nodal modulator 2"	"NOMO1"
"26S proteasome non-ATPase regulatory subunit 1"	"PSMD1"
"Lethal(2) giant larvae protein homolog 1"	"LLGL1"
"DNA polymerase delta subunit 2"	"POLD2"
"60S ribosomal protein L17"	"RPL17"
"NADH dehydrogenase [ubiquinone] 1 alpha subcomplex subunit 10, mitochondrial"	"NDUFA10"
"ATPase ASNA1"	"ASNA1"
"Vacuolar protein sorting-associated protein VTA1 homolog"	"VTA1"
"Dachshund homolog 1"	"DACH1"
"AP-2 complex subunit mu"	"AP2M1"
"Ubiquitin-conjugating enzyme E2 D2;Ubiquitin-conjugating enzyme E2 D3"	"UBE2D2"
"PDZ and LIM domain protein 3"	"PDLIM3"
"Selenoprotein H"	"SELH"
"Tumor protein D54"	"TPD52L2"
"UTP--glucose-1-phosphate uridylyltransferase"	"UGP2"
"Prostaglandin E synthase 3"	"PTGES3"
"Ribonucleoprotein PTB-binding 1"	"RAVER1"
"Lys-63-specific deubiquitinase BRCC36"	"BRCC3"
"Hypoxia up-regulated protein 1"	"HYOU1"
"RNA-binding protein 26"	"RBM26"
"Tight junction protein ZO-1"	"TJP1"
"Sorting nexin-12"	"SNX12"
"Collagen alpha-1(VI) chain"	"COL6A1"
"Double-stranded RNA-binding protein Staufen homolog 1"	"STAU1"
"15 kDa selenoprotein"	"X15.Sep"
"Nebulin"	"NEB"
"Proteasome activator complex subunit 2"	"PSME2"
"Calponin;Calponin-2"	"CNN2"
"RNA binding protein fox-1 homolog 1;RNA binding protein fox-1 homolog;RNA binding protein fox-1 homolog 2;RNA binding protein fox-1 homolog 3"	"RBFOX1"
"Serine/arginine-rich splicing factor 3"	"SRSF3"
"ATP-dependent RNA helicase DDX1"	"DDX1"
"26S protease regulatory subunit 10B"	"PSMC6"
"COP9 signalosome complex subunit 1"	"GPS1"
"WD repeat-containing protein 18"	"WDR18"
"Heterogeneous nuclear ribonucleoprotein U-like protein 1"	"HNRNPUL1"
"Band 4.1-like protein 3;Band 4.1-like protein 3, N-terminally processed"	"EPB41L3"
"Sorting nexin-6;Sorting nexin-6, N-terminally processed"	"SNX6"
"Protein-L-isoaspartate O-methyltransferase;Protein-L-isoaspartate(D-aspartate) O-methyltransferase"	"PCMT1"
"Nucleolar and coiled-body phosphoprotein 1"	"NOLC1"
"U1 small nuclear ribonucleoprotein C"	"SNRPC"
"Nuclear factor 1 B-type;Nuclear factor 1"	"NFIB"
"Methyl-CpG-binding domain protein 1"	"MBD1"
"Hydroxyacyl-coenzyme A dehydrogenase, mitochondrial"	"HADH"
"Torsin-1A-interacting protein 1"	"TOR1AIP1"
"Phosphatidylinositol transfer protein beta isoform"	"PITPNB"
"NADPH:adrenodoxin oxidoreductase, mitochondrial"	"FDXR"
"Sodium/potassium-transporting ATPase subunit alpha-3"	"ATP1A3"
"Protein SCAF8"	"SCAF8"
"Transcription activator BRG1"	"SMARCA4"
"Isovaleryl-CoA dehydrogenase, mitochondrial"	"IVD"
"Cytoplasmic dynein 1 intermediate chain 1"	"DYNC1I1"
"Delta(24)-sterol reductase"	"DHCR24"
"Titin"	"TTN"
"Adenylosuccinate lyase"	"ADSL"
"Transmembrane emp24 domain-containing protein 7"	"TMED7"
"Putative RNA-binding protein Luc7-like 2"	"LUC7L2"
"N-alpha-acetyltransferase 15, NatA auxiliary subunit"	"NAA15"
"Serine/arginine-rich splicing factor 7"	"SRSF7"
"Pre-mRNA 3-end-processing factor FIP1"	"FIP1L1"
"La-related protein 1"	"LARP1"
"Sedoheptulokinase"	"TRPV1"
"3-ketoacyl-CoA thiolase, mitochondrial"	"ACAA2"
"40S ribosomal protein S15"	"RPS15"
"Disks large-associated protein 4"	"DLGAP4"
"Translationally-controlled tumor protein;TPT1-like protein"	"TPT1"
"Transmembrane 9 superfamily member 4"	"TM9SF4"
"Protein SET;Protein SETSIP"	"SET"
"DNA (cytosine-5)-methyltransferase 3A"	"DNMT3A"
"40S ribosomal protein SA"	"RPSA"
"Nesprin-1"	"SYNE1"
"Probable ATP-dependent RNA helicase DDX46"	"DDX46"
"Enoyl-CoA delta isomerase 2, mitochondrial"	"ECI2"
"Short coiled-coil protein"	"SCOC"
"Chromodomain-helicase-DNA-binding protein 4"	"CHD4"
"Poly(A) polymerase alpha;Poly(A) polymerase beta"	"PAPOLA"
"Calpain small subunit 1"	"CAPNS1"
"Regulation of nuclear pre-mRNA domain-containing protein 1A"	"RPRD1A"
"NADH dehydrogenase [ubiquinone] 1 alpha subcomplex subunit 6"	"NDUFA6"
"Dolichyl-diphosphooligosaccharide--protein glycosyltransferase 48 kDa subunit"	"DDOST"
"Ragulator complex protein LAMTOR5"	"LAMTOR5"
"Enolase-phosphatase E1"	"ENOPH1"
"Mitogen-activated protein kinase kinase kinase kinase 4;Misshapen-like kinase 1;TRAF2 and NCK-interacting protein kinase"	"MAP4K4"
"ATP-dependent RNA helicase DDX3X"	"DDX3X"
"Syntaxin-binding protein 1"	"STXBP1"
"PHD finger protein 6"	"PHF6"
"Spectrin alpha chain, non-erythrocytic 1"	"SPTAN1"
"Histone-lysine N-methyltransferase EHMT2"	"EHMT2"
"Heat shock 70 kDa protein 1B;Heat shock 70 kDa protein 1A"	"HSPA1B"
"Casein kinase II subunit beta"	"CSNK2B.LY6G5B.1181"
"Poly(U)-binding-splicing factor PUF60"	"PUF60"
"Tripartite motif-containing protein 2"	"TRIM2"
"Serum paraoxonase/arylesterase 2"	"PON2"
"Protein canopy homolog 4"	"CNPY4"
"ELAV-like protein;ELAV-like protein 4"	"ELAVL4"
"Matrin-3"	"MATR3"
"Tropomyosin alpha-1 chain"	"TPM1"
"Protein kinase C and casein kinase substrate in neurons protein 2"	"PACSIN2"
"Histone H2A type 1-J;Histone H2A type 1-H;Histone H2A type 1-D;Histone H2A type 1;Histone H2A.J;Histone H2A"	"HIST1H2AJ"
"Serine/threonine-protein kinase DCLK2"	"DCLK2"
"Polypyrimidine tract-binding protein 1"	"PTBP1"
"Protein enabled homolog"	"ENAH"
"Fermitin family homolog 2"	"FERMT2"
"Putative HLA class I histocompatibility antigen, alpha chain H;HLA class I histocompatibility antigen, Cw-18 alpha chain;HLA class I histocompatibility antigen, Cw-6 alpha chain;HLA class I histocompatibility antigen, Cw-7 alpha chain;HLA class I histocompatibility antigen, Cw-1 alpha chain;HLA class I histocompatibility antigen, B-8 alpha chain;HLA class I histocompatibility antigen, alpha chain E;HLA class I histocompatibility antigen, B-7 alpha chain;HLA class I histocompatibility antigen, B-39 alpha chain;HLA class I histocompatibility antigen, B-42 alpha chain;HLA class I histocompatibility antigen, B-37 alpha chain;HLA class I histocompatibility antigen, B-82 alpha chain;HLA class I histocompatibility antigen, B-67 alpha chain;HLA class I histocompatibility antigen, B-81 alpha chain;HLA class I histocompatibility antigen, B-38 alpha chain;HLA class I histocompatibility antigen, B-48 alpha chain;HLA class I histocompatibility antigen, B-14 alpha chain"	"HLA.C"
"Alpha-ketoglutarate-dependent dioxygenase FTO"	"FTO"
"Alpha-aminoadipic semialdehyde dehydrogenase"	"ALDH7A1"
"Acid ceramidase;Acid ceramidase subunit alpha;Acid ceramidase subunit beta"	"ASAH1"
"AT-rich interactive domain-containing protein 1A"	"ARID1A"
"Aminoacylase-1"	"ACY1"
"Cathepsin D;Cathepsin D light chain;Cathepsin D heavy chain"	"CTSD"
"Kinesin-like protein;Kinesin-like protein KIF21A"	"KIF21A"
"Ubiquitin-protein ligase E3A"	"UBE3A"
"Neuronal migration protein doublecortin"	"DCX"
"Dihydropyrimidinase-related protein 2"	"DPYSL2"
"NAD-dependent malic enzyme, mitochondrial"	"ME2"
"Protein DDX26B"	"DDX26B"
"DNA-directed RNA polymerase;DNA-directed RNA polymerase II subunit RPB2"	"POLR2B"
"Lysosome membrane protein 2"	"SCARB2"
"Transcription elongation factor A protein 1"	"TCEA1"
"Probable ATP-dependent RNA helicase DDX17"	"DDX17"
"Mitochondrial import inner membrane translocase subunit Tim9"	"TIMM9"
"Glial fibrillary acidic protein"	"GFAP"
"D-3-phosphoglycerate dehydrogenase"	"PHGDH"
"Palmitoyl-protein thioesterase 1"	"PPT1"
"Neuronal-specific septin-3"	"X3.Sep"
"SWI/SNF-related matrix-associated actin-dependent regulator of chromatin subfamily E member 1"	"SMARCE1"
"Catenin beta-1"	"CTNNB1"
"Tubulin-specific chaperone E"	"TBCE"
"Radixin"	"RDX"
"60S ribosomal protein L5"	"RPL5"
"D-tyrosyl-tRNA(Tyr) deacylase 1;D-tyrosyl-tRNA(Tyr) deacylase"	"DTD1"
"Succinyl-CoA ligase [ADP-forming] subunit beta, mitochondrial"	"SUCLA2"
"Protein 4.1"	"EPB41"
"40S ribosomal protein S14"	"RPS14"
"40S ribosomal protein S29"	"RPS29"
"ATP-dependent 6-phosphofructokinase, muscle type"	"PFKM"
"Peroxisomal multifunctional enzyme type 2;(3R)-hydroxyacyl-CoA dehydrogenase;Enoyl-CoA hydratase 2"	"HSD17B4"
"Casein kinase II subunit alpha;Casein kinase II subunit alpha 3"	"CSNK2A1"
"Glutamine synthetase"	"GLUL"
"Ribosomal protein L15;60S ribosomal protein L15"	"RPL15"
"Tripeptidyl-peptidase 1"	"TPP1"
"Parafibromin"	"CDC73"
"Elongation factor 1-alpha 2"	"EEF1A2"
"CD59 glycoprotein"	"CD59"
"C-1-tetrahydrofolate synthase, cytoplasmic;Methylenetetrahydrofolate dehydrogenase;Methenyltetrahydrofolate cyclohydrolase;Formyltetrahydrofolate synthetase;C-1-tetrahydrofolate synthase, cytoplasmic, N-terminally processed"	"MTHFD1"
"CTP synthase 1;CTP synthase"	"CTPS1"
"Mannosyl-oligosaccharide glucosidase"	"MOGS"
"Translocon-associated protein subunit alpha"	"SSR1"
"Treacle protein"	"TCOF1"
"m7GpppX diphosphatase"	"DCPS"
"Phosphoglucomutase-1"	"PGM1"
"60S ribosomal protein L29"	"RPL29"
"ATP synthase subunit g, mitochondrial"	"ATP5L"
"Thyroid hormone receptor-associated protein 3"	"THRAP3"
"DNA replication licensing factor MCM4"	"MCM4"
"NHP2-like protein 1;NHP2-like protein 1, N-terminally processed"	"NHP2L1"
"Pre-mRNA-processing factor 40 homolog A"	"PRPF40A"
"Uncharacterized protein C11orf98"	"C11orf98"
"Myosin phosphatase Rho-interacting protein"	"MPRIP"
"Peptidyl-prolyl cis-trans isomerase NIMA-interacting 4"	"PIN4"
"Protein DEK"	"DEK"
"3-beta-hydroxysteroid-Delta(8),Delta(7)-isomerase"	"EBP"
"Nucleolar protein 56"	"NOP56"
"Xaa-Pro dipeptidase"	"PEPD"
"Lamin-B receptor"	"LBR"
"Peptidyl-prolyl cis-trans isomerase FKBP2"	"FKBP2"
"Squamous cell carcinoma antigen recognized by T-cells 3"	"SART3"
"Protein disulfide-isomerase A4"	"PDIA4"
"Cytochrome b5 type B"	"CYB5B"
"Ubiquitin-like modifier-activating enzyme 6"	"UBA6"
"Acetolactate synthase-like protein"	"ILVBL"
"SH3 and PX domain-containing protein 2B"	"SH3PXD2B"
"Aconitate hydratase, mitochondrial"	"ACO2"
"Stathmin"	"STMN1"
"Microtubule-associated proteins 1A/1B light chain 3B;Microtubule-associated proteins 1A/1B light chain 3 beta 2"	"MAP1LC3B"
"Cullin-4B;Cullin-4A"	"CUL4B"
"Host cell factor 1;HCF N-terminal chain 1;HCF N-terminal chain 2;HCF N-terminal chain 3;HCF N-terminal chain 4;HCF N-terminal chain 5;HCF N-terminal chain 6;HCF C-terminal chain 1;HCF C-terminal chain 2;HCF C-terminal chain 3;HCF C-terminal chain 4;HCF C-terminal chain 5;HCF C-terminal chain 6"	"HCFC1"
"GPI-anchor transamidase"	"PIGK"
"3(2),5-bisphosphate nucleotidase 1"	"BPNT1"
"ADP-sugar pyrophosphatase"	"NUDT5"
"Hematological and neurological expressed 1-like protein"	"HN1L"
"Structural maintenance of chromosomes flexible hinge domain-containing protein 1"	"SMCHD1"
"Protein unc-119 homolog B"	"UNC119B"
"Ubiquitin carboxyl-terminal hydrolase;Ubiquitin carboxyl-terminal hydrolase 14"	"USP14"
"Aminopeptidase B"	"RNPEP"
"Tetraspanin;CD81 antigen"	"CD81"
"Alpha-endosulfine;cAMP-regulated phosphoprotein 19"	"ENSA"
"Tumor suppressor p53-binding protein 1"	"TP53BP1"
"Mesencephalic astrocyte-derived neurotrophic factor"	"MANF"
"Protein SFI1 homolog"	"SFI1"
"Fragile X mental retardation protein 1"	"FMR1"
"Protein S100-B"	"S100B"
"60S ribosomal protein L7"	"RPL7"
"ATP synthase-coupling factor 6, mitochondrial"	"ATP5J"
"60S ribosomal protein L23a"	"RPL23A"
"Fatty acid-binding protein, liver"	"FABP1"
"Small nuclear ribonucleoprotein G;Putative small nuclear ribonucleoprotein G-like protein 15"	"SNRPG"
"Protein SEC13 homolog"	"SEC13"
"Eukaryotic translation initiation factor 3 subunit L"	"EIF3L"
"RNA-binding protein EWS"	"EWSR1"
"Apolipoprotein C-III"	"APOC3"
"26S proteasome non-ATPase regulatory subunit 10"	"PSMD10"
"DnaJ homolog subfamily C member 11"	"DNAJC11"
"Ribose-phosphate pyrophosphokinase 1"	"PRPS1"
"Septin-6"	"X6.Sep"
"Guanylate kinase"	"GUK1"
"Polyadenylate-binding protein;Polyadenylate-binding protein 4"	"PABPC4"
"Heterogeneous nuclear ribonucleoproteins C1/C2"	"HNRNPC"
"Eukaryotic translation initiation factor 3 subunit H"	"EIF3H"
"Histidine--tRNA ligase, cytoplasmic"	"HARS"
"NADH dehydrogenase [ubiquinone] flavoprotein 1, mitochondrial"	"NDUFV1"
"Methylated-DNA--protein-cysteine methyltransferase"	"MGMT"
"RNA-binding protein Musashi homolog 2"	"MSI2"
"COP9 signalosome complex subunit 2"	"COPS2"
"NADH-ubiquinone oxidoreductase 75 kDa subunit, mitochondrial"	"NDUFS1"
"Citrate synthase, mitochondrial;Citrate synthase"	"CS"
"Aldo-keto reductase family 1 member C2"	"AKR1C2"
"Cysteine--tRNA ligase, cytoplasmic"	"CARS"
"39S ribosomal protein L12, mitochondrial"	"MRPL12"
"Protein transport protein Sec61 subunit alpha isoform 1;Protein transport protein Sec61 subunit alpha isoform 2"	"SEC61A1"
"S-methyl-5-thioadenosine phosphorylase;Purine nucleoside phosphorylase"	"MTAP"
"Brain-specific angiogenesis inhibitor 1-associated protein 2"	"BAIAP2"
"Echinoderm microtubule-associated protein-like 4"	"EML4"
"Basic leucine zipper and W2 domain-containing protein 2"	"BZW2"
"Septin-10"	"X10.Sep"
"Heterogeneous nuclear ribonucleoprotein L-like"	"HNRNPLL"
"Reticulon"	"RTN3"
"Lysosomal acid phosphatase"	"ACP2"
"Ran-binding protein 3"	"RANBP3"
"Medium-chain specific acyl-CoA dehydrogenase, mitochondrial"	"ACADM"
"Endophilin-B2"	"SH3GLB2"
"Peptidyl-prolyl cis-trans isomerase-like 3;Peptidyl-prolyl cis-trans isomerase"	"PPIL3"
"Gamma-glutamylcyclotransferase"	"GGCT"
"Small ubiquitin-related modifier;Small ubiquitin-related modifier 1"	"SUMO1"
"Prothymosin alpha;Prothymosin alpha, N-terminally processed;Thymosin alpha-1"	"PTMA"
"Transcription elongation factor B polypeptide 2"	"TCEB2"
"U4/U6.U5 tri-snRNP-associated protein 2"	"USP39"
"Malate dehydrogenase, cytoplasmic"	"MDH1"
"MICOS complex subunit MIC60"	"IMMT"
"RNA-binding protein 12B"	"RBM12B"
"Translin-associated protein X"	"TSNAX"
"Basic leucine zipper and W2 domain-containing protein 1"	"BZW1"
"Choline-phosphate cytidylyltransferase A;Choline-phosphate cytidylyltransferase B"	"PCYT1A"
"Profilin"	"PFN2"
"Sorcin"	"SRI"
"Eukaryotic translation elongation factor 1 epsilon-1"	"EEF1E1"
"60S ribosomal protein L37a"	"RPL37A"
"Peptidyl-prolyl cis-trans isomerase;Peptidyl-prolyl cis-trans isomerase G"	"PPIG"
"MKI67 FHA domain-interacting nucleolar phosphoprotein"	"NIFK"
"Transportin-3"	"TNPO3"
"V-type proton ATPase subunit E 1"	"ATP6V1E1"
"Translocon-associated protein subunit gamma"	"SSR3"
"Phosphoserine phosphatase"	"PSPH"
"Nicotinate-nucleotide pyrophosphorylase [carboxylating]"	"QPRT"
"N-acetyl-D-glucosamine kinase"	"NAGK"
"Cytochrome c"	"CYCS"
"Proline-, glutamic acid- and leucine-rich protein 1"	"PELP1"
"Acylamino-acid-releasing enzyme"	"APEH"
"Cysteine protease ATG4B"	"ATG4B"
"ATP synthase subunit f, mitochondrial"	"ATP5J2.PTCD1"
"Protein FAM195B"	"FAM195B"
"Metaxin-2"	"MTX2"
"60S ribosomal protein L24"	"RPL24"
"Cartilage-associated protein"	"CRTAP"
"MICOS complex subunit MIC19"	"CHCHD3"
"DCN1-like protein;DCN1-like protein 1"	"DCUN1D1"
"Catenin delta-1"	"CTNND1"
"Eukaryotic translation initiation factor 4 gamma 2"	"EIF4G2"
"60S ribosomal protein L32"	"RPL32"
"Calcium/calmodulin-dependent protein kinase type II subunit delta"	"CAMK2D"
"Heterogeneous nuclear ribonucleoprotein A/B"	"HNRNPAB"
"Glucosamine-6-phosphate isomerase;Glucosamine-6-phosphate isomerase 1"	"GNPDA1"
"Transmembrane protein 33"	"TMEM33"
"COP9 signalosome complex subunit 4"	"COPS4"
"Vesicular integral-membrane protein VIP36"	"LMAN2"
"Eukaryotic translation initiation factor 4E"	"EIF4E"
"Polyadenylate-binding protein-interacting protein 1"	"PAIP1"
"Peptidyl-prolyl cis-trans isomerase CWC27 homolog"	"CWC27"
"Septin-11"	"X11.Sep"
"Protein transport protein Sec31A"	"SEC31A"
"Succinate dehydrogenase [ubiquinone] flavoprotein subunit, mitochondrial"	"SDHA"
"Cytochrome c oxidase subunit 7A2, mitochondrial"	"COX7A2"
"Exosome complex component RRP45"	"EXOSC9"
"Acyl-protein thioesterase 1"	"LYPLA1"
"Prefoldin subunit 1"	"PFDN1"
"Stathmin;Stathmin-2"	"STMN2"
"Transcription elongation factor B polypeptide 1"	"TCEB1"
"60S ribosomal protein L30"	"RPL30"
"Phospholipase A-2-activating protein"	"PLAA"
"Tubulin-specific chaperone A"	"TBCA"
"S-phase kinase-associated protein 1"	"SKP1"
"Annexin"	"ANXA6"
"COP9 signalosome complex subunit 6"	"COPS6"
"Flotillin-2"	"FLOT2"
"Epididymal secretory protein E1"	"NPC2"
"AP-1 complex subunit mu-1"	"AP1M1"
"Alpha-adducin"	"ADD1"
"60S ribosomal protein L14"	"RPL14"
"Septin-7"	"X7.Sep"
"Alpha-synuclein"	"SNCA"
"Beta-galactosidase"	"GLB1"
"N-alpha-acetyltransferase 50"	"NAA50"
"Ezrin"	"EZR"
"High mobility group protein B3"	"HMGB3"
"Focal adhesion kinase 1"	"PTK2"
"Cyclin-dependent kinase 2"	"CDK2"
"Neurofilament medium polypeptide"	"NEFM"
"Metastasis-associated protein MTA1"	"MTA1"
"U2 snRNP-associated SURP motif-containing protein"	"U2SURP"
"Glutathione peroxidase;Probable glutathione peroxidase 8"	"GPX8"
"Eukaryotic translation initiation factor 4 gamma 1"	"EIF4G1"
"Microtubule-associated protein;Microtubule-associated protein 4"	"MAP4"
"Protein polybromo-1"	"PBRM1"
"Kinesin light chain 1"	"KLC1"
"Cytoplasmic FMR1-interacting protein 2"	"CYFIP2"
"U4/U6 small nuclear ribonucleoprotein Prp31"	"PRPF31"
"Sal-like protein 2"	"SALL2"
"Cleavage stimulation factor subunit 2;Cleavage stimulation factor subunit 2 tau variant"	"CSTF2"
"Eukaryotic translation initiation factor 4B"	"EIF4B"
"Dynactin subunit 1"	"DCTN1"
"Nascent polypeptide-associated complex subunit alpha;Nascent polypeptide-associated complex subunit alpha, muscle-specific form"	"NACA"
"2-oxoglutarate dehydrogenase, mitochondrial"	"OGDH"
"Structural maintenance of chromosomes protein;Structural maintenance of chromosomes protein 4"	"SMC4"
"Unconventional myosin-Ib"	"MYO1B"
"Far upstream element-binding protein 1"	"FUBP1"
"Acetyltransferase component of pyruvate dehydrogenase complex;Dihydrolipoyllysine-residue acetyltransferase component of pyruvate dehydrogenase complex, mitochondrial"	"DLAT"
"Nuclear pore complex protein Nup155"	"NUP155"
"Dynein heavy chain 12, axonemal"	"DNAH12"
"Translin"	"TSN"
"NADH dehydrogenase [ubiquinone] 1 beta subcomplex subunit 9"	"NDUFB9"
"LanC-like protein 1"	"LANCL1"
"Band 4.1-like protein 2"	"EPB41L2"
"Nuclear transcription factor Y subunit gamma"	"NFYC"
"Mitochondrial carrier homolog 2"	"MTCH2"
"Thy-1 membrane glycoprotein"	"THY1"
"Nuclear RNA export factor 1"	"NXF1"
"Methylosome subunit pICln"	"CLNS1A"
"Protein wntless homolog"	"WLS"
"Protein arginine N-methyltransferase 1"	"PRMT1"
"Nucleolar transcription factor 1"	"UBTF"
"60S ribosomal protein L8"	"RPL8"
"Puromycin-sensitive aminopeptidase"	"NPEPPS"
"60S ribosomal protein L27a"	"RPL27A"
"Vitamin K epoxide reductase complex subunit 1"	"VKORC1"
"Cleavage stimulation factor subunit 3"	"CSTF3"
"Squalene synthase"	"FDFT1"
"mRNA export factor"	"RAE1"
"Histone-lysine N-methyltransferase SETDB1"	"SETDB1"
"Prefoldin subunit 4"	"PFDN4"
"40S ribosomal protein S30"	"FAU"
"COUP transcription factor 1;COUP transcription factor 2"	"NR2F1"
"Rab-like protein 6"	"RABL6"
"Copine-1"	"CPNE1"
"Pyridoxal kinase"	"PDXK"
"Toll-interacting protein"	"TOLLIP"
"60S ribosomal protein L35"	"RPL35"
"Prostaglandin reductase 1"	"PTGR1"
"Multifunctional methyltransferase subunit TRM112-like protein"	"TRMT112"
"Protein C10"	"C12orf57"
"Dolichyl-diphosphooligosaccharide--protein glycosyltransferase subunit DAD1"	"DAD1"
"SPARC"	"SPARC"
"Ubiquitin thioesterase OTUB1"	"OTUB1"
"Homeobox protein Meis2;Homeobox protein Meis1;Putative homeobox protein Meis3-like 1;Homeobox protein Meis3"	"MEIS2"
"4F2 cell-surface antigen heavy chain"	"SLC3A2"
"High mobility group protein HMGI-C"	"HMGA2"
"Protein transport protein Sec23A"	"SEC23A"
"Nucleosome assembly protein 1-like 1"	"NAP1L1"
"Microsomal glutathione S-transferase 1"	"MGST1"
"DNA repair protein XRCC1"	"XRCC1"
"Set1/Ash2 histone methyltransferase complex subunit ASH2"	"ASH2L"
"N-acetylglucosamine-6-sulfatase"	"GNS"
"Glyoxalase domain-containing protein 4"	"GLOD4"
"Polymerase delta-interacting protein 3"	"POLDIP3"
"Serine/threonine-protein phosphatase 2A activator"	"PPP2R4"
"CAD protein;Glutamine-dependent carbamoyl-phosphate synthase;Aspartate carbamoyltransferase;Dihydroorotase"	"CAD"
"LIM domain and actin-binding protein 1"	"LIMA1"
"60S ribosomal protein L18"	"RPL18"
"Coatomer subunit zeta-1"	"COPZ1"
"Phosphate carrier protein, mitochondrial"	"SLC25A3"
"SWI/SNF complex subunit SMARCC2"	"SMARCC2"
"Vacuolar protein sorting-associated protein 29"	"VPS29"
"Serine/threonine-protein phosphatase;Serine/threonine-protein phosphatase PP1-gamma catalytic subunit"	"PPP1CC"
"ADP-ribosylation factor-like protein 1"	"ARL1"
"Aladin"	"AAAS"
"Chromatin complexes subunit BAP18"	"C17orf49"
"Adenylate kinase 2, mitochondrial;Adenylate kinase 2, mitochondrial;Adenylate kinase 2, mitochondrial, N-terminally processed"	"AK2"
"Myosin light polypeptide 6"	"MYL6"
"Nuclear receptor-binding protein"	"NRBP1"
"Heterogeneous nuclear ribonucleoprotein A1;Heterogeneous nuclear ribonucleoprotein A1, N-terminally processed;Heterogeneous nuclear ribonucleoprotein A1-like 2"	"HNRNPA1"
"Ubiquitin-associated protein 2-like"	"UBAP2L"
"Double-strand break repair protein MRE11A"	"MRE11A"
"Nucleolysin TIA-1 isoform p40"	"TIA1"
"Insulin-like growth factor 2 mRNA-binding protein 2"	"IGF2BP2"
"CLIP-associating protein 1"	"CLASP1"
"NADH dehydrogenase [ubiquinone] 1 alpha subcomplex subunit 5"	"NDUFA5"
"Vesicle-associated membrane protein 3;Vesicle-associated membrane protein 2"	"VAMP2"
"Actin-related protein 2/3 complex subunit 4"	"ARPC4.TTLL3"
"Clathrin light chain A"	"CLTA"
"Cleavage and polyadenylation specificity factor subunit 6"	"CPSF6"
"Caprin-1"	"CAPRIN1"
"Dipeptidyl peptidase 3"	"DPP3"
"Apoptosis inhibitor 5"	"API5"
"Paired mesoderm homeobox protein 1"	"PRRX1"
"Acylphosphatase;Acylphosphatase-1"	"ACYP1"
"Signal recognition particle 54 kDa protein"	"SRP54"
"Glia maturation factor beta"	"GMFB"
"Proteasome subunit alpha type;Proteasome subunit alpha type-6"	"PSMA6"
"Catenin alpha-1"	"CTNNA1"
"SWI/SNF-related matrix-associated actin-dependent regulator of chromatin subfamily B member 1"	"SMARCB1"
"Syntenin-1"	"SDCBP"
"CUGBP Elav-like family member 1"	"CELF1"
"Protein transport protein Sec24C"	"SEC24C"
"Heterogeneous nuclear ribonucleoprotein H;Heterogeneous nuclear ribonucleoprotein H, N-terminally processed"	"HNRNPH1"
"Dynamin-1-like protein"	"DNM1L"
"Zyxin"	"ZYX"
"Dolichol-phosphate mannosyltransferase subunit 1"	"DPM1"
"Inosine-5-monophosphate dehydrogenase 2"	"IMPDH2"
"60S ribosomal protein L36a;60S ribosomal protein L36a-like"	"RPL36A"
"Nicastrin"	"NCSTN"
"Importin-5"	"IPO5"
"2-deoxynucleoside 5-phosphate N-hydrolase 1"	"DNPH1"
"Translation machinery-associated protein 16"	"TMA16"
"Inositol monophosphatase 1"	"IMPA1"
"Tetratricopeptide repeat protein 9C"	"TTC9C"
"Serine/threonine-protein phosphatase 5;Serine/threonine-protein phosphatase"	"PPP5C"
"40S ribosomal protein S2"	"RPS2"
"Trifunctional enzyme subunit alpha, mitochondrial;Long-chain enoyl-CoA hydratase;Long chain 3-hydroxyacyl-CoA dehydrogenase"	"HADHA"
"Protein lin-7 homolog C;Protein lin-7 homolog A"	"LIN7A"
"YLP motif-containing protein 1"	"YLPM1"
"Cytochrome c oxidase subunit 6A1, mitochondrial"	"COX6A1"
"Serine/threonine-protein phosphatase 2A 56 kDa regulatory subunit gamma isoform;Serine/threonine-protein phosphatase 2A 56 kDa regulatory subunit epsilon isoform;Serine/threonine-protein phosphatase 2A 56 kDa regulatory subunit delta isoform"	"PPP2R5C"
"60S ribosomal protein L28"	"RPL28"
"Signal peptidase complex catalytic subunit SEC11;Signal peptidase complex catalytic subunit SEC11A"	"SEC11A"
"Tropomodulin-3"	"TMOD3"
"Proteasome subunit alpha type;Proteasome subunit alpha type-4;Proteasome subunit beta type"	"PSMA4"
"Acidic leucine-rich nuclear phosphoprotein 32 family member A"	"ANP32A"
"Deoxyuridine 5-triphosphate nucleotidohydrolase, mitochondrial"	"DUT"
"Aflatoxin B1 aldehyde reductase member 2"	"AKR7A2"
"RNA-binding protein with serine-rich domain 1"	"RNPS1"
"Mannose-6-phosphate isomerase"	"MPI"
"40S ribosomal protein S17"	"RPS17"
"Ubiquitin carboxyl-terminal hydrolase;Ubiquitin carboxyl-terminal hydrolase 7"	"USP7"
"Cytosolic Fe-S cluster assembly factor NUBP2"	"NUBP2"
"4-aminobutyrate aminotransferase, mitochondrial"	"ABAT"
"Cytochrome c oxidase subunit 5A, mitochondrial"	"COX5A"
"NADH dehydrogenase [ubiquinone] 1 beta subcomplex subunit 10"	"NDUFB10"
"Adenine phosphoribosyltransferase"	"APRT"
"Cytochrome b-c1 complex subunit 2, mitochondrial"	"UQCRC2"
"Gamma-aminobutyric acid receptor-associated protein-like 2"	"GABARAPL2"
"Serine/threonine-protein phosphatase;Serine/threonine-protein phosphatase 4 catalytic subunit"	"PPP4C"
"Probable glutamate--tRNA ligase, mitochondrial"	"EARS2"
"Pyruvate kinase"	"PKM"
"Leucine carboxyl methyltransferase 1"	"LCMT1"
"39S ribosomal protein L21, mitochondrial"	"MRPL21"
"Gamma-aminobutyric acid receptor-associated protein;Gamma-aminobutyric acid receptor-associated protein-like 1"	"GABARAP"
"Nucleoporin p58/p45"	"NUPL1"
"Protein phosphatase 1 regulatory subunit 7"	"PPP1R7"
"Nuclear pore complex protein Nup98-Nup96;Nuclear pore complex protein Nup98;Nuclear pore complex protein Nup96"	"NUP98"
"Vesicle-fusing ATPase"	"NSF"
"Microtubule-associated protein;Microtubule-associated protein tau"	"MAPT"
"Mitochondrial 2-oxoglutarate/malate carrier protein"	"SLC25A11"
"Eukaryotic translation initiation factor 5A;Eukaryotic translation initiation factor 5A-1;Eukaryotic translation initiation factor 5A-1-like;Eukaryotic translation initiation factor 5A-2"	"EIF5A"
"Ribosomal L1 domain-containing protein 1"	"RSL1D1"
"Vacuolar protein sorting-associated protein 4A"	"VPS4A"
"Nuclear pore complex protein Nup88"	"NUP88"
"26S proteasome non-ATPase regulatory subunit 9"	"PSMD9"
"Cytochrome b5"	"CYB5A"
"Transducin beta-like protein 3"	"TBL3"
"Serine/arginine-rich splicing factor 2"	"SRSF2"
"Luc7-like protein 3"	"LUC7L3"
"Obg-like ATPase 1"	"OLA1"
"Isoleucine--tRNA ligase, cytoplasmic"	"IARS"
"BUB3-interacting and GLEBS motif-containing protein ZNF207"	"ZNF207"
"Hematological and neurological expressed 1 protein;Hematological and neurological expressed 1 protein, N-terminally processed"	"HN1"
"60S ribosomal protein L38"	"RPL38"
"Probable ATP-dependent RNA helicase DDX5"	"DDX5"
"Ribosomal protein L19;60S ribosomal protein L19"	"RPL19"
"Serine/arginine-rich splicing factor 1"	"SRSF1"
"Small nuclear ribonucleoprotein-associated protein N;Small nuclear ribonucleoprotein-associated proteins B and B"	"SNRPN"
"SAP30-binding protein"	"SAP30BP"
"60S ribosomal protein L26;60S ribosomal protein L26-like 1"	"RPL26"
"Myosin regulatory light chain 12A;Myosin regulatory light chain 12B"	"MYL12A"
"Mitotic checkpoint protein BUB3"	"BUB3"
"Methyl-CpG-binding domain protein 3"	"MBD3"
"Katanin p60 ATPase-containing subunit A-like 2"	"KATNAL2"
"Protein syndesmos"	"NUDT16L1"
"Lon protease homolog, mitochondrial"	"LONP1"
"26S proteasome non-ATPase regulatory subunit 8"	"PSMD8"
"DAZ-associated protein 1"	"DAZAP1"
"Protein LSM12 homolog"	"LSM12"
"Glucosidase 2 subunit beta"	"PRKCSH"
"Putative oxidoreductase GLYR1"	"GLYR1"
"Nicalin"	"NCLN"
"mRNA cap guanine-N7 methyltransferase"	"RNMT"
"RNA-binding protein 42"	"RBM42"
"Hsp90 co-chaperone Cdc37;Hsp90 co-chaperone Cdc37, N-terminally processed"	"CDC37"
"DNA ligase 3"	"LIG3"
"Haloacid dehalogenase-like hydrolase domain-containing protein 2"	"HDHD2"
"Phenylalanine--tRNA ligase alpha subunit"	"FARSA"
"3-ketodihydrosphingosine reductase"	"KDSR"
"Eukaryotic translation initiation factor 3 subunit K"	"EIF3K"
"Dual specificity protein phosphatase 3"	"DUSP3"
"Coatomer subunit epsilon"	"COPE"
"Myeloid-derived growth factor"	"MYDGF"
"rRNA 2-O-methyltransferase fibrillarin"	"FBL"
"Nuclear pore glycoprotein p62"	"NUP62"
"Mitochondrial import inner membrane translocase subunit TIM44"	"TIMM44"
"Bifunctional polynucleotide phosphatase/kinase;Polynucleotide 3-phosphatase;Polynucleotide 5-hydroxyl-kinase"	"PNKP"
"Putative uncharacterized protein LOC400499"	"Putative.uncharacterized.protein.LOC400499"
"Exosome complex component RRP46"	"EXOSC5"
"40S ribosomal protein S5;40S ribosomal protein S5, N-terminally processed"	"RPS5"
"60S ribosomal protein L18a"	"RPL18A"
"60S ribosomal protein L21"	"RPL21"
"Charged multivesicular body protein 2a"	"CHMP2A"
"DNA polymerase;DNA polymerase delta catalytic subunit"	"POLD1"
"SURP and G-patch domain-containing protein 2"	"SUGP2"
"Alkyldihydroxyacetonephosphate synthase, peroxisomal"	"AGPS"
"Kinesin-like protein KIF2A"	"KIF2A"
"ATP-dependent RNA helicase DDX39A"	"DDX39A"
"Cytosolic acyl coenzyme A thioester hydrolase"	"ACOT7"
"AH receptor-interacting protein"	"AIP"
"AP-3 complex subunit beta-1"	"AP3B1"
"26S proteasome non-ATPase regulatory subunit 11"	"PSMD11"
"26S proteasome non-ATPase regulatory subunit 12"	"PSMD12"
"Membrane-associated progesterone receptor component 1"	"PGRMC1"
"Transcription elongation factor SPT5"	"SUPT5H"
"DNA fragmentation factor subunit alpha"	"DFFA"
"Huntingtin-interacting protein 1"	"HIP1"
"Chloride intracellular channel protein 1"	"CLIC1"
"Eukaryotic translation initiation factor 3 subunit F"	"EIF3F"
"Histone deacetylase complex subunit SAP18"	"SAP18"
"Insulin-like growth factor 2 mRNA-binding protein 3"	"IGF2BP3"
"Procollagen-lysine,2-oxoglutarate 5-dioxygenase 2"	"PLOD2"
"Cytochrome c oxidase subunit NDUFA4"	"NDUFA4"
"26S proteasome non-ATPase regulatory subunit 14"	"PSMD14"
"Importin subunit alpha-4"	"KPNA3"
"Pirin"	"PIR"
"Importin subunit alpha-3"	"KPNA4"
"Serine/threonine-protein phosphatase 6 catalytic subunit;Serine/threonine-protein phosphatase 6 catalytic subunit, N-terminally processed"	"PPP6C"
"Lysosomal alpha-mannosidase;Lysosomal alpha-mannosidase A peptide;Lysosomal alpha-mannosidase B peptide;Lysosomal alpha-mannosidase C peptide;Lysosomal alpha-mannosidase D peptide;Lysosomal alpha-mannosidase E peptide"	"MAN2B1"
"Dihydropyrimidinase-related protein 4"	"DPYSL4"
"Eukaryotic translation initiation factor 1A, X-chromosomal;Eukaryotic translation initiation factor 1A, Y-chromosomal"	"EIF1AX"
"Programmed cell death protein 5"	"PDCD5"
"Protein arginine N-methyltransferase 5;Protein arginine N-methyltransferase 5, N-terminally processed"	"PRMT5"
"Na(+)/H(+) exchange regulatory cofactor NHE-RF1"	"SLC9A3R1"
"Transcription elongation regulator 1"	"TCERG1"
"Proteasome subunit alpha type-7"	"PSMA7"
"Histone acetyltransferase type B catalytic subunit"	"HAT1"
"Hepatocyte growth factor-regulated tyrosine kinase substrate"	"HGS"
"Exportin-1"	"XPO1"
"Phosphoribosylformylglycinamidine synthase"	"PFAS"
"Serine/threonine-protein kinase DCLK1"	"DCLK1"
"U6 snRNA-associated Sm-like protein LSm1"	"LSM1"
"Niemann-Pick C1 protein"	"NPC1"
"Actin-related protein 2/3 complex subunit 2"	"ARPC2"
"Actin-related protein 2/3 complex subunit 3"	"ARPC3"
"Membrane-associated progesterone receptor component 2"	"PGRMC2"
"Prefoldin subunit 6"	"PFDN6"
"Serine palmitoyltransferase 1"	"SPTLC1"
"UDP-N-acetylglucosamine--peptide N-acetylglucosaminyltransferase 110 kDa subunit"	"OGT"
"Protein phosphatase 1G"	"PPM1G"
"Eukaryotic translation initiation factor 3 subunit D"	"EIF3D"
"Syntaxin-7"	"STX7"
"Actin-related protein 2/3 complex subunit 5"	"ARPC5"
"Fatty acid-binding protein, brain"	"FABP7"
"Pre-mRNA-splicing factor ATP-dependent RNA helicase DHX15"	"DHX15"
"U4/U6 small nuclear ribonucleoprotein Prp4"	"PRPF4"
"Cytoplasmic dynein 1 light intermediate chain 2"	"DYNC1LI2"
"26S proteasome non-ATPase regulatory subunit 3"	"PSMD3"
"Bifunctional 3-phosphoadenosine 5-phosphosulfate synthase 1;Sulfate adenylyltransferase;Adenylyl-sulfate kinase"	"PAPSS1"
"U4/U6.U5 tri-snRNP-associated protein 1"	"SART1"
"RNA-binding protein Musashi homolog 1"	"MSI1"
"Heterogeneous nuclear ribonucleoprotein R"	"HNRNPR"
"Thioredoxin-like protein 1"	"TXNL1"
"Exportin-T"	"XPOT"
"Pleiotropic regulator 1"	"PLRG1"
"Alpha-actinin-4"	"ACTN4"
"HIV Tat-specific factor 1"	"HTATSF1"
"AP-1 complex subunit gamma-1"	"AP1G1"
"Small glutamine-rich tetratricopeptide repeat-containing protein alpha"	"SGTA"
"Asparagine--tRNA ligase, cytoplasmic"	"NARS"
"Cleavage and polyadenylation specificity factor subunit 5"	"NUDT21"
"Calumenin"	"CALU"
"Putative adenosylhomocysteinase 2;Adenosylhomocysteinase;Putative adenosylhomocysteinase 3"	"AHCYL1"
"NADH dehydrogenase [ubiquinone] iron-sulfur protein 5"	"NDUFS5"
"Double-strand-break repair protein rad21 homolog"	"RAD21"
"Mitochondrial import inner membrane translocase subunit Tim8 A"	"TIMM8A"
"Phosphoribosyl pyrophosphate synthase-associated protein 2"	"PRPSAP2"
"SWI/SNF-related matrix-associated actin-dependent regulator of chromatin subfamily A member 5"	"SMARCA5"
"Kinesin heavy chain isoform 5C;Kinesin-like protein;Kinesin heavy chain isoform 5A"	"KIF5C"
"Intron-binding protein aquarius"	"AQR"
"Lysine-specific histone demethylase 1A"	"KDM1A"
"Sorting nexin-3"	"SNX3"
"Protein O-GlcNAcase"	"MGEA5"
"Heterogeneous nuclear ribonucleoprotein Q"	"SYNCRIP"
"Perilipin-3"	"PLIN3"
"Importin subunit alpha-7;Importin subunit alpha-6;Importin subunit alpha-5;Importin subunit alpha-5, N-terminally processed"	"KPNA6"
"UDP-glucose 6-dehydrogenase"	"UGDH"
"Eukaryotic translation initiation factor 1b"	"EIF1B"
"Sorting nexin-2"	"SNX2"
"General vesicular transport factor p115"	"USO1"
"Histone H2B;Histone H2B type 1-M;Histone H2B type 1-N;Histone H2B type 1-H;Histone H2B type 2-F;Histone H2B type 1-C/E/F/G/I;Histone H2B type 1-D;Histone H2B type 1-K;Histone H2B type F-S;Histone H2B type 1-L"	"HIST1H2BN"
"H/ACA ribonucleoprotein complex subunit 4"	"DKC1"
"Endothelial differentiation-related factor 1"	"EDF1"
"Bromodomain-containing protein 4"	"BRD4"
"Protein CutA"	"CUTA"
"WD repeat-containing protein 1"	"WDR1"
"Copine-3"	"CPNE3"
"NADH dehydrogenase [ubiquinone] iron-sulfur protein 2, mitochondrial"	"NDUFS2"
"Protein NipSnap homolog 2"	"GBAS"
"Programmed cell death protein 6"	"PDCD6"
"V-type proton ATPase subunit G 1"	"ATP6V1G1"
"Core histone macro-H2A.1;Histone H2A"	"H2AFY"
"SH3 domain-binding glutamic acid-rich-like protein"	"SH3BGRL"
"Filamin-B"	"FLNB"
"NADH dehydrogenase [ubiquinone] iron-sulfur protein 6, mitochondrial"	"NDUFS6"
"Vesicle-trafficking protein SEC22b"	"SEC22B"
"Vacuolar protein sorting-associated protein 26A"	"VPS26A"
"Mitochondrial-processing peptidase subunit beta"	"PMPCB"
"PC4 and SFRS1-interacting protein"	"PSIP1"
"Erlin-1"	"ERLIN1"
"NADH dehydrogenase [ubiquinone] iron-sulfur protein 3, mitochondrial"	"NDUFS3"
"Serine/arginine-rich splicing factor 10"	"SRSF10"
"Heat shock factor-binding protein 1"	"HSBP1"
"Barrier-to-autointegration factor;Barrier-to-autointegration factor, N-terminally processed"	"BANF1"
"Splicing factor 3B subunit 1"	"SF3B1"
"Cold shock domain-containing protein E1"	"CSDE1"
"Interferon-inducible double-stranded RNA-dependent protein kinase activator A"	"PRKRA"
"Nucleoplasmin-3"	"NPM3"
"Serpin B7"	"SERPINB7"
"U5 small nuclear ribonucleoprotein 200 kDa helicase"	"SNRNP200"
"TIP41-like protein"	"TIPRL"
"Paralemmin-1"	"PALM"
"Eukaryotic translation initiation factor 3 subunit G"	"EIF3G"
"Eukaryotic translation initiation factor 3 subunit J"	"EIF3J"
"Isocitrate dehydrogenase [NADP] cytoplasmic"	"IDH1"
"PRA1 family protein 3"	"ARL6IP5"
"Pre-mRNA-splicing factor SPF27"	"BCAS2"
"DnaJ homolog subfamily C member 8"	"DNAJC8"
"ATP synthase subunit d, mitochondrial"	"ATP5H"
"Flotillin-1"	"FLOT1"
"Glutaredoxin-3"	"GLRX3"
"Gamma-synuclein"	"SNCG"
"Signal recognition particle subunit SRP72"	"SRP72"
"N(G),N(G)-dimethylarginine dimethylaminohydrolase 1"	"DDAH1"
"Metastasis-associated protein MTA2"	"MTA2"
"Mitochondrial import receptor subunit TOM70"	"TOMM70A"
"UBX domain-containing protein 7"	"UBXN7"
"Proline synthase co-transcribed bacterial homolog protein"	"PROSC"
"Erlin-2"	"ERLIN2"
"Pre-mRNA-processing factor 6"	"PRPF6"
"AP-2 complex subunit alpha-2"	"AP2A2"
"Reticulon-3"	"RTN3.1"
"LETM1 and EF-hand domain-containing protein 1, mitochondrial"	"LETM1"
"Zinc finger Ran-binding domain-containing protein 2"	"ZRANB2"
"Vesicle-associated membrane protein-associated protein B/C"	"VAPB"
"SNARE-associated protein Snapin"	"SNAPIN"
"Peptidyl-prolyl cis-trans isomerase FKBP9"	"FKBP9"
"6-phosphogluconolactonase"	"PGLS"
"Structural maintenance of chromosomes protein 2"	"SMC2"
"Importin-7"	"IPO7"
"Activator of 90 kDa heat shock protein ATPase homolog 1"	"AHSA1"
"Long-chain-fatty-acid--CoA ligase 3;Long-chain-fatty-acid--CoA ligase 4"	"ACSL3"
"N-acetylserotonin O-methyltransferase-like protein"	"ASMTL"
"Phosphatidate cytidylyltransferase 2"	"CDS2"
"Serine/threonine-protein kinase OSR1"	"OXSR1"
"Heat shock 70 kDa protein 4L"	"HSPA4L"
"U6 snRNA-associated Sm-like protein LSm8"	"LSM8"
"AP-2 complex subunit alpha-1"	"AP2A1"
"Apoptosis-inducing factor 1, mitochondrial"	"AIFM1"
"Fatty acid desaturase 2"	"FADS2"
"N(G),N(G)-dimethylarginine dimethylaminohydrolase 2"	"DDAH2"
"Thioredoxin domain-containing protein 12"	"TXNDC12"
"Mitochondrial import receptor subunit TOM40 homolog"	"TOMM40"
"Actin-like protein 6A"	"ACTL6A"
"Histone-lysine N-methyltransferase NSD2"	"WHSC1"
"L-lactate dehydrogenase A chain"	"LDHA"
"Retinal dehydrogenase 1"	"ALDH1A1"
"Glutamate dehydrogenase 1, mitochondrial;Glutamate dehydrogenase 2, mitochondrial"	"GLUD1"
"NADH-cytochrome b5 reductase 3;NADH-cytochrome b5 reductase 3 membrane-bound form;NADH-cytochrome b5 reductase 3 soluble form"	"CYB5R3"
"Glutathione reductase, mitochondrial"	"GSR"
"Cytochrome c oxidase subunit 2"	"MT.CO2"
"Superoxide dismutase [Cu-Zn]"	"SOD1"
"Purine nucleoside phosphorylase"	"PNP"
"Hypoxanthine-guanine phosphoribosyltransferase"	"HPRT1"
"Aspartate aminotransferase, mitochondrial"	"GOT2"
"Phosphoglycerate kinase 1"	"PGK1"
"Adenylate kinase isoenzyme 1"	"AK1"
"Carbonic anhydrase 2"	"CA2"
"GTPase KRas;GTPase KRas, N-terminally processed"	"KRAS"
"Collagen alpha-1(I) chain"	"COL1A1"
"Collagen alpha-1(III) chain"	"COL3A1"
"Prelamin-A/C;Lamin-A/C"	"LMNA"
"Transferrin receptor protein 1;Transferrin receptor protein 1, serum form"	"TFRC"
"Ferritin heavy chain;Ferritin heavy chain, N-terminally processed;Ferritin"	"FTH1"
"Catalase"	"CAT"
"Fructose-bisphosphate aldolase A;Fructose-bisphosphate aldolase"	"ALDOA"
"Cystatin-B"	"CSTB"
"Annexin A1;Annexin"	"ANXA1"
"Superoxide dismutase [Mn], mitochondrial"	"SOD2"
"Ornithine aminotransferase, mitochondrial;Ornithine aminotransferase, hepatic form;Ornithine aminotransferase, renal form"	"OAT"
"Semenogelin-1;Alpha-inhibin-92;Alpha-inhibin-31;Seminal basic protein"	"SEMG1"
"Tubulin beta-4A chain"	"TUBB4A"
"Glyceraldehyde-3-phosphate dehydrogenase"	"GAPDH"
"Heat shock protein beta-1"	"HSPB1"
"Dolichyl-diphosphooligosaccharide--protein glycosyltransferase subunit 1"	"RPN1"
"Dolichyl-diphosphooligosaccharide--protein glycosyltransferase subunit 2"	"RPN2"
"Guanine nucleotide-binding protein G(i) subunit alpha-2"	"GNAI2"
"Histone H2A type 1-C;Histone H2A type 3;Histone H2A type 1-B/E"	"HIST1H2AC"
"Sodium/potassium-transporting ATPase subunit alpha-1"	"ATP1A1"
"Sodium/potassium-transporting ATPase subunit beta-1"	"ATP1B1"
"Aldehyde dehydrogenase, mitochondrial"	"ALDH2"
"Non-histone chromosomal protein HMG-14"	"HMGN1"
"ADP/ATP translocase 2;ADP/ATP translocase 2, N-terminally processed"	"SLC25A5"
"Eukaryotic translation initiation factor 2 subunit 1"	"EIF2S1"
"Non-histone chromosomal protein HMG-17;High mobility group nucleosome-binding domain-containing protein 3"	"HMGN2"
"60S acidic ribosomal protein P1"	"RPLP1"
"60S acidic ribosomal protein P2"	"RPLP2"
"60S acidic ribosomal protein P0;60S acidic ribosomal protein P0-like"	"RPLP0"
"Lupus La protein"	"SSB"
"Integrin beta-1"	"ITGB1"
"Keratin, type I cytoskeletal 18"	"KRT18"
"ATP synthase subunit beta, mitochondrial;ATP synthase subunit beta"	"ATP5B"
"Protein S100;Protein S100-A6"	"S100A6"
"Alpha-enolase"	"ENO1"
"Glucose-6-phosphate isomerase"	"GPI"
"Nucleophosmin"	"NPM1"
"Histone H2B type 2-E;Histone H2B type 1-B;Histone H2B type 1-O;Histone H2B type 1-J"	"HIST2H2BE"
"Epoxide hydrolase 1"	"EPHX1"
"Acyl-CoA-binding protein"	"DBI"
"L-lactate dehydrogenase B chain;L-lactate dehydrogenase"	"LDHB"
"Neurofilament light polypeptide"	"NEFL"
"Protein disulfide-isomerase"	"P4HB"
"Histone H1.0;Histone H1.0, N-terminally processed"	"H1F0"
"Annexin A2;Annexin;Putative annexin A2-like protein"	"ANXA2"
"Calpain-1 catalytic subunit"	"CAPN1"
"Tubulin beta chain"	"TUBB"
"Prosaposin;Saposin-A;Saposin-B-Val;Saposin-B;Saposin-C;Saposin-D"	"PSAP"
"Beta-hexosaminidase subunit beta;Beta-hexosaminidase subunit beta chain B;Beta-hexosaminidase subunit beta chain A"	"HEXB"
"Profilin-1"	"PFN1"
"Bifunctional glutamate/proline--tRNA ligase;Glutamate--tRNA ligase;Proline--tRNA ligase"	"EPRS"
"Cathepsin B;Cathepsin B light chain;Cathepsin B heavy chain"	"CTSB"
"Heat shock protein HSP 90-alpha"	"HSP90AA1"
"Cytochrome b-c1 complex subunit 6, mitochondrial"	"UQCRH"
"Fumarate hydratase, mitochondrial"	"FH"
"Annexin A6;Annexin"	"ANXA6.1"
"Heat shock protein HSP 90-beta"	"HSP90AB1"
"Cytochrome c1, heme protein, mitochondrial"	"CYC1"
"U2 small nuclear ribonucleoprotein B"	"SNRPB2"
"U1 small nuclear ribonucleoprotein 70 kDa"	"SNRNP70"
"Vimentin"	"VIM"
"Annexin A5;Annexin"	"ANXA5"
"U1 small nuclear ribonucleoprotein A"	"SNRPA"
"Gamma-enolase;Enolase"	"ENO2"
"Glutathione S-transferase P"	"GSTP1"
"Galectin-1"	"LGALS1"
"Dihydropteridine reductase"	"QDPR"
"High mobility group protein B1;Putative high mobility group protein B1-like 1"	"HMGB1"
"Retinol-binding protein 1"	"RBP1"
"Glutathione S-transferase Mu 1;Glutathione S-transferase Mu 4"	"GSTM1"
"Annexin A4;Annexin"	"ANXA4"
"2,3-cyclic-nucleotide 3-phosphodiesterase"	"CNP"
"Dihydrolipoyl dehydrogenase, mitochondrial;Dihydrolipoyl dehydrogenase"	"DLD"
"U2 small nuclear ribonucleoprotein A"	"SNRPA1"
"Poly [ADP-ribose] polymerase 1"	"PARP1"
"Ubiquitin carboxyl-terminal hydrolase isozyme L1;Ubiquitin carboxyl-terminal hydrolase"	"UCHL1"
"Leukotriene A-4 hydrolase"	"LTA4H"
"Fructose-bisphosphate aldolase C;Fructose-bisphosphate aldolase"	"ALDOC"
"Histone H2A.V;Histone H2A.Z;Histone H2A"	"H2AFV"
"Thymosin beta-15B;Thymosin beta-15A"	"TMSB15B"
"POTE ankyrin domain family member J"	"POTEJ"
"Splicing factor U2AF 35 kDa subunit;Splicing factor U2AF 26 kDa subunit"	"U2AF1"
"Cystathionine beta-synthase"	"CBS"
"60 kDa SS-A/Ro ribonucleoprotein"	"TROVE2"
"Lysosomal alpha-glucosidase;76 kDa lysosomal alpha-glucosidase;70 kDa lysosomal alpha-glucosidase"	"GAA"
"Histone H1.4"	"HIST1H1E"
"Thioredoxin"	"TXN"
"Cytochrome c oxidase subunit 5B, mitochondrial"	"COX5B"
"cAMP-dependent protein kinase type I-alpha regulatory subunit;cAMP-dependent protein kinase type I-alpha regulatory subunit, N-terminally processed"	"PRKAR1A"
"S-formylglutathione hydrolase"	"ESD"
"60 kDa heat shock protein, mitochondrial"	"HSPD1"
"78 kDa glucose-regulated protein"	"HSPA5"
"Microtubule-associated protein 2"	"MAP2"
"Heat shock cognate 71 kDa protein"	"HSPA8"
"Pyruvate dehydrogenase E1 component subunit beta, mitochondrial"	"PDHB"
"Glycogen phosphorylase, brain form"	"PYGB"
"Lysosome-associated membrane glycoprotein 1"	"LAMP1"
"DNA topoisomerase 1"	"TOP1"
"DNA topoisomerase 2-alpha"	"TOP2A"
"Glucose-6-phosphate 1-dehydrogenase"	"G6PD"
"Pyruvate carboxylase, mitochondrial"	"PC"
"Cation-independent mannose-6-phosphate receptor"	"IGF2R"
"Alcohol dehydrogenase class-3"	"ADH5"
"Proliferating cell nuclear antigen"	"PCNA"
"ADP/ATP translocase 1"	"SLC25A4"
"ADP/ATP translocase 3;ADP/ATP translocase 3, N-terminally processed"	"SLC25A6"
"Nucleoprotein TPR"	"TPR"
"Creatine kinase B-type"	"CKB"
"Alpha-actinin-1"	"ACTN1"
"Proto-oncogene tyrosine-protein kinase Src"	"SRC"
"X-ray repair cross-complementing protein 6"	"XRCC6"
"X-ray repair cross-complementing protein 5"	"XRCC5"
"Cytochrome c oxidase subunit 4 isoform 1, mitochondrial"	"COX4I1"
"Lysosome-associated membrane glycoprotein 2"	"LAMP2"
"Ribonuclease inhibitor"	"RNH1"
"Elongation factor 2"	"EEF2"
"Prolyl 4-hydroxylase subunit alpha-1"	"P4HA1"
"Plastin-3"	"PLS3"
"Electron transfer flavoprotein subunit alpha, mitochondrial"	"ETFA"
"Glycogen [starch] synthase, muscle"	"GYS1"
"cAMP-dependent protein kinase type II-alpha regulatory subunit"	"PRKAR2A"
"General transcription factor IIF subunit 2"	"GTF2F2"
"Macrophage migration inhibitory factor"	"MIF"
"Farnesyl pyrophosphate synthase"	"FDPS"
"Alcohol dehydrogenase [NADP(+)]"	"AKR1A1"
"Pyruvate kinase PKM;Pyruvate kinase"	"PKM.1"
"Endoplasmin"	"HSP90B1"
"Cytochrome c oxidase subunit 6B1"	"COX6B1"
"Heterogeneous nuclear ribonucleoprotein L"	"HNRNPL"
"Aspartate--tRNA ligase, cytoplasmic"	"DARS"
"Cytochrome b-c1 complex subunit 7"	"UQCRB"
"Aldose reductase"	"AKR1B1"
"Eukaryotic peptide chain release factor GTP-binding subunit ERF3A"	"GSPT1"
"Ubiquitin carboxyl-terminal hydrolase isozyme L3;Ubiquitin carboxyl-terminal hydrolase"	"UCHL3"
"Replication protein A 32 kDa subunit"	"RPA2"
"Cytochrome c oxidase subunit 7C, mitochondrial"	"COX7C"
"Histone H2AX;Histone H2A type 1-A"	"H2AFX"
"Carbonyl reductase [NADPH] 1"	"CBR1"
"Serine/threonine-protein phosphatase;Serine/threonine-protein phosphatase 2B catalytic subunit beta isoform;Serine/threonine-protein phosphatase 2B catalytic subunit alpha isoform"	"PPP3CB"
"Histone H1.5"	"HIST1H1B"
"Histone H1.3"	"HIST1H1D"
"Histone H1.2"	"HIST1H1C"
"NADPH--cytochrome P450 reductase"	"POR"
"Sarcoplasmic/endoplasmic reticulum calcium ATPase 2"	"ATP2A2"
"Zinc finger protein 22"	"ZNF22"
"Alpha-N-acetylgalactosaminidase"	"NAGA"
"Heat shock 70 kDa protein 6;Putative heat shock 70 kDa protein 7"	"HSPA6"
"High mobility group protein HMG-I/HMG-Y"	"HMGA1"
"Aspartate aminotransferase, cytoplasmic"	"GOT1"
"cAMP-dependent protein kinase catalytic subunit alpha"	"PRKACA"
"Desmin"	"DES"
"Neuromodulin"	"GAP43"
"ATP-dependent 6-phosphofructokinase, liver type"	"PFKL"
"Galectin-3;Galectin"	"LGALS3"
"T-complex protein 1 subunit alpha"	"TCP1"
"Tyrosine-protein phosphatase non-receptor type 1;Tyrosine-protein phosphatase non-receptor type"	"PTPN1"
"60S ribosomal protein L35a"	"RPL35A"
"ADP-ribosylation factor 4"	"ARF4"
"Vinculin"	"VCL"
"Protein SON"	"SON"
"Phosphoglycerate mutase 1"	"PGAM1"
"Regulator of chromosome condensation"	"RCC1"
"Nucleolin"	"NCL"
"Hexokinase-1"	"HK1"
"DNA-directed RNA polymerase II subunit RPB3"	"POLR2C"
"Interferon-induced, double-stranded RNA-activated protein kinase"	"EIF2AK2"
"Spermidine synthase"	"SRM"
"Casein kinase II subunit alpha"	"CSNK2A2"
"Eukaryotic translation initiation factor 2 subunit 2"	"EIF2S2"
"Annexin A7"	"ANXA7"
"POU domain, class 3, transcription factor 2;POU domain, class 3, transcription factor 3;POU domain, class 3, transcription factor 1"	"POU3F2"
"Transcription factor BTF3"	"BTF3"
"Ras-related protein Rab-6A"	"RAB6A"
"Proteasome subunit beta type-1"	"PSMB1"
"Lamin-B1"	"LMNB1"
"Parathymosin"	"PTMS"
"Glutathione S-transferase Mu 3"	"GSTM3"
"V-type proton ATPase subunit B, brain isoform"	"ATP6V1B2"
"Filamin-A"	"FLNA"
"Cytoplasmic aconitate hydratase"	"ACO1"
"Voltage-dependent anion-selective channel protein 1"	"VDAC1"
"Catechol O-methyltransferase"	"COMT"
"Methylmalonyl-CoA mutase, mitochondrial"	"MUT"
"Oxysterol-binding protein 1"	"OSBP"
"Trifunctional purine biosynthetic protein adenosine-3;Phosphoribosylamine--glycine ligase;Phosphoribosylformylglycinamidine cyclo-ligase;Phosphoribosylglycinamide formyltransferase"	"GART"
"Multifunctional protein ADE2;Phosphoribosylaminoimidazole-succinocarboxamide synthase;Phosphoribosylaminoimidazole carboxylase"	"PAICS"
"Non-specific lipid-transfer protein"	"SCP2"
"Ubiquitin-like modifier-activating enzyme 1"	"UBA1"
"Heterogeneous nuclear ribonucleoproteins A2/B1"	"HNRNPA2B1"
"Splicing factor, proline- and glutamine-rich"	"SFPQ"
"Tubulin gamma-2 chain;Tubulin gamma-1 chain;Tubulin gamma chain"	"TUBG2"
"Peptidyl-prolyl cis-trans isomerase B"	"PPIB"
"Glycine dehydrogenase (decarboxylating), mitochondrial"	"GLDC"
"Tryptophan--tRNA ligase, cytoplasmic;T1-TrpRS;T2-TrpRS"	"WARS"
"40S ribosomal protein S3"	"RPS3"
"Adenosylhomocysteinase"	"AHCY"
"Cofilin-1"	"CFL1"
"Thymidylate kinase"	"DTYMK"
"Ribonucleoside-diphosphate reductase large subunit"	"RRM1"
"Elongation factor 1-beta"	"EEF1B2"
"ATP synthase F(0) complex subunit B1, mitochondrial"	"ATP5F1"
"Low molecular weight phosphotyrosine protein phosphatase"	"ACP1"
"Acetyl-CoA acetyltransferase, mitochondrial"	"ACAT1"
"DNA-directed RNA polymerase II subunit RPB1"	"POLR2A"
"DNA replication licensing factor MCM3"	"MCM3"
"3-mercaptopyruvate sulfurtransferase;Sulfurtransferase"	"MPST"
"40S ribosomal protein S12"	"RPS12"
"DnaJ homolog subfamily B member 1"	"DNAJB1"
"ATP synthase subunit alpha, mitochondrial"	"ATP5A1"
"Proteasome subunit alpha type-1;Proteasome subunit alpha type"	"PSMA1"
"Proteasome subunit alpha type-3"	"PSMA3"
"Moesin"	"MSN"
"Probable ATP-dependent RNA helicase DDX6"	"DDX6"
"DNA (cytosine-5)-methyltransferase 1"	"DNMT1"
"Splicing factor U2AF 65 kDa subunit"	"U2AF2"
"60S ribosomal protein L13"	"RPL13"
"High mobility group protein B2"	"HMGB2"
"Threonine--tRNA ligase, cytoplasmic"	"TARS"
"Valine--tRNA ligase"	"VARS"
"Elongation factor 1-gamma"	"EEF1G"
"Adenylate kinase 4, mitochondrial"	"AK4"
"14-3-3 protein theta"	"YWHAQ"
"60S ribosomal protein L10"	"RPL10"
"Replication protein A 70 kDa DNA-binding subunit;Replication protein A 70 kDa DNA-binding subunit, N-terminally processed"	"RPA1"
"DNA-(apurinic or apyrimidinic site) lyase;DNA-(apurinic or apyrimidinic site) lyase, mitochondrial"	"APEX1"
"Calreticulin"	"CALR"
"Calnexin"	"CANX"
"Proteasome subunit alpha type-5"	"PSMA5"
"Proteasome subunit beta type-4"	"PSMB4"
"Proteasome subunit beta type-6;Proteasome subunit beta type"	"PSMB6"
"Proteasome subunit beta type-5"	"PSMB5"
"Glutathione S-transferase Mu 2"	"GSTM2"
"ATP-binding cassette sub-family D member 3"	"ABCD3"
"Mitogen-activated protein kinase 1"	"MAPK1"
"Granulins;Acrogranin;Paragranulin;Granulin-1;Granulin-2;Granulin-3;Granulin-4;Granulin-5;Granulin-6;Granulin-7"	"GRN"
"Cytosol aminopeptidase"	"LAP3"
"Cellular retinoic acid-binding protein 2"	"CRABP2"
"Transketolase"	"TKT"
"Elongation factor 1-delta"	"EEF1D"
"Cellular retinoic acid-binding protein 1"	"CRABP1"
"Myristoylated alanine-rich C-kinase substrate"	"MARCKS"
"Delta-1-pyrroline-5-carboxylate dehydrogenase, mitochondrial"	"ALDH4A1"
"Endoplasmic reticulum resident protein 29"	"ERP29"
"Peroxiredoxin-6"	"PRDX6"
"Peroxiredoxin-5, mitochondrial"	"PRDX5"
"D-dopachrome decarboxylase;D-dopachrome decarboxylase-like protein"	"DDT"
"Thioredoxin-dependent peroxide reductase, mitochondrial"	"PRDX3"
"ATP synthase subunit delta, mitochondrial"	"ATP5D"
"60S ribosomal protein L12"	"RPL12"
"Enoyl-CoA hydratase, mitochondrial"	"ECHS1"
"UMP-CMP kinase"	"CMPK1"
"Phosphatidylethanolamine-binding protein 1;Hippocampal cholinergic neurostimulating peptide"	"PEBP1"
"Protein disulfide-isomerase A3"	"PDIA3.1"
"Serine/threonine-protein phosphatase 2A 65 kDa regulatory subunit A alpha isoform"	"PPP2R1A"
"Adenylosuccinate synthetase isozyme 2"	"ADSS"
"Alpha-2-macroglobulin receptor-associated protein"	"LRPAP1"
"Aldehyde dehydrogenase X, mitochondrial"	"ALDH1B1"
"Rab GDP dissociation inhibitor alpha"	"GDI1"
"S-adenosylmethionine synthase isoform type-2"	"MAT2A"
"Carbamoyl-phosphate synthase [ammonia], mitochondrial"	"CPS1"
"DnaJ homolog subfamily A member 1"	"DNAJA1"
"RAC-alpha serine/threonine-protein kinase"	"AKT1"
"Cytochrome b-c1 complex subunit 1, mitochondrial"	"UQCRC1"
"3-hydroxyisobutyrate dehydrogenase, mitochondrial"	"HIBADH"
"Bifunctional purine biosynthesis protein PURH;Phosphoribosylaminoimidazolecarboxamide formyltransferase;IMP cyclohydrolase"	"ATIC"
"Heterogeneous nuclear ribonucleoprotein H3"	"HNRNPH3"
"14-3-3 protein beta/alpha;14-3-3 protein beta/alpha, N-terminally processed"	"YWHAB"
"Stress-induced-phosphoprotein 1"	"STIP1"
"Protein S100-A11;Protein S100-A11, N-terminally processed"	"S100A11"
"Peroxiredoxin-2"	"PRDX2"
"Deoxycytidylate deaminase"	"DCTD"
"Pyrroline-5-carboxylate reductase 1, mitochondrial;Pyrroline-5-carboxylate reductase"	"PYCR1"
"60S ribosomal protein L9"	"RPL9"
"Kinesin-1 heavy chain"	"KIF5B"
"DNA replication licensing factor MCM5;DNA helicase"	"MCM5"
"DNA replication licensing factor MCM7"	"MCM7"
"Serine hydroxymethyltransferase, mitochondrial;Serine hydroxymethyltransferase"	"SHMT2"
"Heat shock 70 kDa protein 4"	"HSPA4"
"Prohibitin"	"PHB"
"Replication protein A 14 kDa subunit"	"RPA3"
"Replication factor C subunit 4"	"RFC4"
"Replication factor C subunit 2"	"RFC2"
"60S ribosomal protein L22"	"RPL22"
"General transcription factor IIF subunit 1"	"GTF2F1"
"Myosin-9"	"MYH9"
"Myosin-10"	"MYH10"
"Coatomer subunit beta"	"COPB2"
"Beta-adducin"	"ADD2"
"RNA-binding protein FUS"	"FUS"
"Hydroxymethylglutaryl-CoA lyase, mitochondrial"	"HMGCL"
"26S protease regulatory subunit 7"	"PSMC2"
"ADP-ribosylation factor-like protein 3"	"ARL3"
"ATP synthase subunit gamma, mitochondrial"	"ATP5C1"
"60S ribosomal protein L4"	"RPL4"
"7,8-dihydro-8-oxoguanine triphosphatase"	"NUDT1"
"Dihydrolipoyllysine-residue succinyltransferase component of 2-oxoglutarate dehydrogenase complex, mitochondrial"	"DLST"
"Signal recognition particle 14 kDa protein"	"SRP14"
"Transgelin-2"	"TAGLN2"
"Transaldolase"	"TALDO1"
"Electron transfer flavoprotein subunit beta"	"ETFB"
"RNA-binding motif protein, X chromosome;RNA-binding motif protein, X chromosome, N-terminally processed;RNA binding motif protein, X-linked-like-1"	"RBMX"
"V-type proton ATPase catalytic subunit A"	"ATP6V1A"
"Stress-70 protein, mitochondrial"	"HSPA9"
"Eukaryotic initiation factor 4A-III;Eukaryotic initiation factor 4A-III, N-terminally processed"	"EIF4A3"
"40S ribosomal protein S19"	"RPS19"
"60S ribosomal protein L3"	"RPL3"
"Flap endonuclease 1"	"FEN1"
"T-complex protein 1 subunit zeta"	"CCT6A"
"60S ribosomal protein L13a"	"RPL13A"
"Signal transducer and activator of transcription 3;Signal transducer and activator of transcription"	"STAT3"
"Malate dehydrogenase, mitochondrial;Malate dehydrogenase"	"MDH2"
"Replication factor C subunit 3"	"RFC3"
"Eukaryotic translation initiation factor 2 subunit 3;Putative eukaryotic translation initiation factor 2 subunit 3-like protein"	"EIF2S3"
"Centrin-2"	"CETN2"
"Peripherin"	"PRPH"
"Protein BUD31 homolog"	"BUD31"
"Glycine--tRNA ligase"	"GARS"
"Eukaryotic translation initiation factor 1"	"EIF1"
"Beta-centractin"	"ACTR1B"
"Enoyl-CoA delta isomerase 1, mitochondrial"	"ECI1"
"Lamina-associated polypeptide 2, isoform alpha;Thymopoietin;Thymopentin"	"TMPO"
"Lamina-associated polypeptide 2, isoforms beta/gamma;Thymopoietin;Thymopentin"	"TMPO.1"
"Superkiller viralicidic activity 2-like 2"	"SKIV2L2"
"Caspase-3;Caspase-3 subunit p17;Caspase-3 subunit p12"	"CASP3"
"40S ribosomal protein S27"	"RPS27"
"Leucine-rich PPR motif-containing protein, mitochondrial"	"LRPPRC"
"Lysosomal Pro-X carboxypeptidase"	"PRCP"
"Platelet-activating factor acetylhydrolase IB subunit alpha"	"PAFAH1B1"
"DNA mismatch repair protein Msh2"	"MSH2"
"Glycerol-3-phosphate dehydrogenase, mitochondrial;Glycerol-3-phosphate dehydrogenase"	"GPD2"
"Ran-specific GTPase-activating protein"	"RANBP1"
"Nicotinamide phosphoribosyltransferase"	"NAMPT"
"26S protease regulatory subunit 6B"	"PSMC4"
"Voltage-dependent anion-selective channel protein 2"	"VDAC2"
"Chromobox protein homolog 5"	"CBX5"
"Ubiquitin carboxyl-terminal hydrolase 5"	"USP5"
"Ran GTPase-activating protein 1"	"RANGAP1"
"Adapter molecule crk"	"CRK"
"Crk-like protein"	"CRKL"
"40S ribosomal protein S10"	"RPS10"
"Microtubule-associated protein 1B;MAP1B heavy chain;MAP1 light chain LC1"	"MAP1B"
"Ras GTPase-activating-like protein IQGAP1"	"IQGAP1"
"Dolichyl-diphosphooligosaccharide--protein glycosyltransferase subunit STT3A"	"STT3A"
"F-actin-capping protein subunit alpha-2"	"CAPZA2"
"Glutamine--tRNA ligase"	"QARS"
"Cytochrome b-c1 complex subunit Rieske, mitochondrial;Cytochrome b-c1 complex subunit 11;Putative cytochrome b-c1 complex subunit Rieske-like protein 1"	"UQCRFS1"
"ATP synthase subunit O, mitochondrial"	"ATP5O"
"Prolyl endopeptidase"	"PREP"
"Transcription factor SOX-2"	"SOX2"
"Coatomer subunit delta"	"ARCN1"
"Lanosterol synthase"	"LSS"
"Purkinje cell protein 4"	"PCP4"
"Glutathione synthetase"	"GSS"
"T-complex protein 1 subunit epsilon"	"CCT5"
"Nestin"	"NES"
"Heat shock 70 kDa protein 13"	"HSPA13"
"Isocitrate dehydrogenase [NADP], mitochondrial"	"IDH2"
"MARCKS-related protein"	"MARCKSL1"
"4-trimethylaminobutyraldehyde dehydrogenase"	"ALDH9A1"
"60S ribosomal protein L34"	"RPL34"
"Protein ERGIC-53"	"LMAN1"
"Nuclear autoantigenic sperm protein"	"NASP"
"Fatty acid synthase;[Acyl-carrier-protein] S-acetyltransferase;[Acyl-carrier-protein] S-malonyltransferase;3-oxoacyl-[acyl-carrier-protein] synthase;3-oxoacyl-[acyl-carrier-protein] reductase;3-hydroxyacyl-[acyl-carrier-protein] dehydratase;Enoyl-[acyl-carrier-protein] reductase;Oleoyl-[acyl-carrier-protein] hydrolase"	"FASN"
"T-complex protein 1 subunit gamma"	"CCT3"
"Elongation factor Tu, mitochondrial"	"TUFM"
"Signal recognition particle 9 kDa protein"	"SRP9"
"Alanine--tRNA ligase, cytoplasmic"	"AARS"
"Serine--tRNA ligase, cytoplasmic"	"SARS"
"Proteasome subunit beta type-2"	"PSMB2"
"DNA replication licensing factor MCM2"	"MCM2"
"Very long-chain specific acyl-CoA dehydrogenase, mitochondrial"	"ACADVL"
"Transmembrane emp24 domain-containing protein 10"	"TMED10"
"RNA-binding protein 25"	"RBM25"
"Histidine triad nucleotide-binding protein 1"	"HINT1"
"E3 SUMO-protein ligase RanBP2"	"RANBP2"
"Selenide, water dikinase 1"	"SEPHS1"
"GMP synthase [glutamine-hydrolyzing]"	"GMPS"
"Rab GDP dissociation inhibitor beta"	"GDI2"
"Emerin"	"EMD"
"Serpin B9"	"SERPINB9"
"Serpin H1"	"SERPINH1"
"Hsc70-interacting protein;Putative protein FAM10A5;Putative protein FAM10A4"	"ST13"
"Dynamin-2"	"DNM2"
"Bis(5-nucleosyl)-tetraphosphatase [asymmetrical]"	"NUDT2"
"T-complex protein 1 subunit theta"	"CCT8"
"T-complex protein 1 subunit delta"	"CCT4"
"Annexin A11"	"ANXA11"
"Fragile X mental retardation syndrome-related protein 1"	"FXR1"
"Ras-related protein Rab-5C"	"RAB5C"
"Ras-related protein Rab-7a"	"RAB7A"
"Galactokinase"	"GALK1"
"Translocon-associated protein subunit delta"	"SSR4"
"B-cell receptor-associated protein 31"	"BCAP31"
"26S proteasome non-ATPase regulatory subunit 7"	"PSMD7"
"Neuronal membrane glycoprotein M6-a"	"GPM6A"
"Hepatoma-derived growth factor"	"HDGF"
"NADH dehydrogenase [ubiquinone] 1 alpha subcomplex subunit 8"	"NDUFA8"
"Heterogeneous nuclear ribonucleoprotein A3"	"HNRNPA3"
"6-phosphogluconate dehydrogenase, decarboxylating"	"PGD"
"Heterogeneous nuclear ribonucleoprotein M"	"HNRNPM.1"
"Importin subunit alpha-1"	"KPNA2"
"Nuclear cap-binding protein subunit 2"	"NCBP2"
"Rho GDP-dissociation inhibitor 1"	"ARHGDIA"
"Heterogeneous nuclear ribonucleoprotein F;Heterogeneous nuclear ribonucleoprotein F, N-terminally processed"	"HNRNPF"
"DNA mismatch repair protein Msh6"	"MSH6"
"Ribonuclease UK114"	"HRSP12"
"F-actin-capping protein subunit alpha-1"	"CAPZA1"
"Cysteine-rich protein 2"	"CRIP2"
"Biliverdin reductase A"	"BLVRA"
"Tricarboxylate transport protein, mitochondrial"	"SLC25A1"
"ATP-citrate synthase"	"ACLY"
"Succinyl-CoA ligase [ADP/GDP-forming] subunit alpha, mitochondrial"	"SUCLG1"
"Diphosphomevalonate decarboxylase"	"MVD"
"Coatomer subunit beta"	"COPB1"
"Coatomer subunit alpha;Xenin;Proxenin"	"COPA"
"Dipeptidyl peptidase 1;Dipeptidyl peptidase 1 exclusion domain chain;Dipeptidyl peptidase 1 heavy chain;Dipeptidyl peptidase 1 light chain"	"CTSC"
"Activated RNA polymerase II transcriptional coactivator p15"	"SUB1"
"Arginine--tRNA ligase, cytoplasmic"	"RARS"
"Tyrosine--tRNA ligase, cytoplasmic;Tyrosine--tRNA ligase, cytoplasmic, N-terminally processed;Tyrosine--tRNA ligase"	"YARS"
"Branched-chain-amino-acid aminotransferase, cytosolic"	"BCAT1"
"UV excision repair protein RAD23 homolog A"	"RAD23A"
"UV excision repair protein RAD23 homolog B"	"RAD23B"
"Delta-1-pyrroline-5-carboxylate synthase;Glutamate 5-kinase;Gamma-glutamyl phosphate reductase"	"ALDH18A1"
"Alpha-soluble NSF attachment protein"	"NAPA"
"Eukaryotic translation initiation factor 5"	"EIF5"
"26S proteasome non-ATPase regulatory subunit 4"	"PSMD4"
"Exportin-2"	"CSE1L"
"Transitional endoplasmic reticulum ATPase"	"VCP"
"Microfibrillar-associated protein 1"	"MFAP1"
"Trifunctional enzyme subunit beta, mitochondrial;3-ketoacyl-CoA thiolase"	"HADHB"
"Caspase-6;Caspase-6 subunit p18;Caspase-6 subunit p11"	"CASP6"
"Double-stranded RNA-specific adenosine deaminase"	"ADAR"
"Heterogeneous nuclear ribonucleoprotein H2"	"HNRNPH2"
"Eukaryotic translation initiation factor 3 subunit B"	"EIF3B"
"Methionine--tRNA ligase, cytoplasmic"	"MARS"
"ATP synthase subunit e, mitochondrial"	"ATP5I"
"Eukaryotic translation initiation factor 6"	"EIF6"
"C-terminal-binding protein 2"	"CTBP2"
"Nuclear pore complex protein Nup107"	"NUP107"
"Myotrophin"	"MTPN"
"Triosephosphate isomerase"	"TPI1"
"Eukaryotic translation initiation factor 3 subunit E"	"EIF3E"
"Actin, cytoplasmic 1;Actin, cytoplasmic 1, N-terminally processed"	"ACTB"
"Eukaryotic initiation factor 4A-I"	"EIF4A1"
"40S ribosomal protein S20"	"RPS20"
"Cell division control protein 42 homolog"	"CDC42"
"Destrin"	"DSTN"
"Ras-related protein Rab-2A"	"RAB2A"
"Ras-related protein Rab-5B"	"RAB5B"
"Ras-related protein Rab-10"	"RAB10"
"NEDD8-conjugating enzyme Ubc12"	"UBE2M"
"Ubiquitin-conjugating enzyme E2 K"	"UBE2K"
"Ubiquitin-conjugating enzyme E2 N"	"UBE2N"
"Ras-related protein Rab-14"	"RAB14"
"Actin-related protein 3"	"ACTR3"
"Actin-related protein 2"	"ACTR2"
"Alpha-centractin"	"ACTR1A"
"ATP-binding cassette sub-family E member 1"	"ABCE1"
"Ras-related protein Rap-1b;Ras-related protein Rap-1A;Ras-related protein Rap-1b-like protein"	"RAP1B"
"40S ribosomal protein S3a"	"RPS3A"
"Proteasome activator complex subunit 3"	"PSME3"
"60S ribosomal protein L27"	"RPL27"
"Pterin-4-alpha-carbinolamine dehydratase"	"PCBD1"
"Transforming protein RhoA;Rho-related GTP-binding protein RhoC"	"RHOA"
"Neurocalcin-delta"	"NCALD"
"10 kDa heat shock protein, mitochondrial"	"HSPE1"
"Small ubiquitin-related modifier 2;Small ubiquitin-related modifier 4;Small ubiquitin-related modifier 3"	"SUMO2"
"Ubiquitin-fold modifier 1"	"UFM1"
"DDB1- and CUL4-associated factor 7"	"DCAF7"
"WD repeat-containing protein 5"	"WDR5"
"Nuclear transport factor 2"	"NUTF2"
"Heterogeneous nuclear ribonucleoprotein K"	"HNRNPK"
"14-3-3 protein gamma;14-3-3 protein gamma, N-terminally processed"	"YWHAG"
"40S ribosomal protein S7"	"RPS7"
"Serine/threonine-protein phosphatase PP1-alpha catalytic subunit;Serine/threonine-protein phosphatase"	"PPP1CA"
"Serine/threonine-protein phosphatase PP1-beta catalytic subunit;Serine/threonine-protein phosphatase"	"PPP1CB"
"26S protease regulatory subunit 4"	"PSMC1"
"26S protease regulatory subunit 8"	"PSMC5"
"40S ribosomal protein S8"	"RPS8"
"40S ribosomal protein S15a"	"RPS15A"
"40S ribosomal protein S16"	"RPS16"
"14-3-3 protein epsilon"	"YWHAE"
"40S ribosomal protein S23"	"RPS23"
"40S ribosomal protein S18"	"RPS18"
"40S ribosomal protein S13"	"RPS13"
"40S ribosomal protein S11"	"RPS11"
"Small nuclear ribonucleoprotein E"	"SNRPE"
"Small nuclear ribonucleoprotein F"	"SNRPF"
"U6 snRNA-associated Sm-like protein LSm3"	"LSM3"
"U6 snRNA-associated Sm-like protein LSm6"	"LSM6"
"Small nuclear ribonucleoprotein Sm D1"	"SNRPD1"
"Small nuclear ribonucleoprotein Sm D2"	"SNRPD2"
"Small nuclear ribonucleoprotein Sm D3"	"SNRPD3"
"Thymosin beta-4;Hematopoietic system regulatory peptide"	"TMSB4X"
"60S ribosomal protein L7a"	"RPL7A"
"DNA-directed RNA polymerase II subunit RPB7"	"POLR2G"
"Eukaryotic peptide chain release factor subunit 1"	"ETF1"
"Cellular nucleic acid-binding protein"	"CNBP"
"40S ribosomal protein S4, X isoform"	"RPS4X"
"Actin, aortic smooth muscle;Actin, gamma-enteric smooth muscle"	"ACTA2"
"40S ribosomal protein S6"	"RPS6"
"Histone H4"	"HIST1H4A"
"Ras-related protein Rab-1A"	"RAB1A"
"GTP-binding nuclear protein Ran"	"RAN"
"60S ribosomal protein L23"	"RPL23"
"40S ribosomal protein S25"	"RPS25"
"40S ribosomal protein S26;Putative 40S ribosomal protein S26-like 1"	"RPS26"
"40S ribosomal protein S28"	"RPS28"
"Guanine nucleotide-binding protein G(I)/G(S)/G(T) subunit beta-1"	"GNB1"
"E3 ubiquitin-protein ligase RBX1;E3 ubiquitin-protein ligase RBX1, N-terminally processed"	"RBX1"
"Guanine nucleotide-binding protein G(I)/G(S)/G(T) subunit beta-2"	"GNB2"
"Putative 60S ribosomal protein L39-like 5;60S ribosomal protein L39"	"RPL39P5"
"60S ribosomal protein L31"	"RPL31"
"60S ribosomal protein L10a"	"RPL10A"
"60S ribosomal protein L11"	"RPL11"
"Peptidyl-prolyl cis-trans isomerase A;Peptidyl-prolyl cis-trans isomerase A, N-terminally processed;Peptidyl-prolyl cis-trans isomerase"	"PPIA"
"Peptidyl-prolyl cis-trans isomerase FKBP1A;Peptidyl-prolyl cis-trans isomerase"	"FKBP1A"
"Ubiquitin-40S ribosomal protein S27a;Ubiquitin;40S ribosomal protein S27a;Polyubiquitin-C;Ubiquitin;Ubiquitin-60S ribosomal protein L40;Ubiquitin;60S ribosomal protein L40;Polyubiquitin-B;Ubiquitin"	"RPS27A"
"Growth factor receptor-bound protein 2"	"GRB2"
"Transformer-2 protein homolog beta"	"TRA2B"
"Ras-related C3 botulinum toxin substrate 1;Ras-related C3 botulinum toxin substrate 2"	"RAC1"
"AP-2 complex subunit beta"	"AP2B1"
"Guanine nucleotide-binding protein G(s) subunit alpha isoforms short;Guanine nucleotide-binding protein G(s) subunit alpha isoforms XLas"	"GNAS"
"14-3-3 protein zeta/delta"	"YWHAZ"
"Serine/threonine-protein phosphatase 2A 55 kDa regulatory subunit B alpha isoform"	"PPP2R2A"
"Dynein light chain 1, cytoplasmic"	"DYNLL1"
"Dynein light chain Tctex-type 1"	"DYNLT1"
"40S ribosomal protein S21"	"RPS21"
"Guanine nucleotide-binding protein subunit beta-2-like 1;Guanine nucleotide-binding protein subunit beta-2-like 1, N-terminally processed"	"GNB2L1"
"Actin, cytoplasmic 2;Actin, cytoplasmic 2, N-terminally processed"	"ACTG1"
"Transcription elongation factor SPT4"	"SUPT4H1"
"SUMO-conjugating enzyme UBC9"	"UBE2I"
"Serine/threonine-protein phosphatase 2A catalytic subunit alpha isoform;Serine/threonine-protein phosphatase 2A catalytic subunit beta isoform"	"PPP2CA"
"Nuclease-sensitive element-binding protein 1;Y-box-binding protein 3"	"YBX1"
"Tropomyosin alpha-4 chain"	"TPM4"
"Actin, alpha cardiac muscle 1;Actin, alpha skeletal muscle"	"ACTC1"
"Ubiquitin-conjugating enzyme E2 L3"	"UBE2L3"
"Elongation factor 1-alpha 1;Putative elongation factor 1-alpha-like 3;Elongation factor 1-alpha"	"EEF1A1"
"Tubulin alpha-1B chain;Tubulin alpha-4A chain"	"TUBA1B"
"Tubulin beta-4B chain"	"TUBB4B"
"Platelet-activating factor acetylhydrolase IB subunit beta"	"PAFAH1B2"
"Histone H3.1;Histone H3.2;Histone H3.1t"	"HIST1H3A"
"Coxsackievirus and adenovirus receptor"	"CXADR"
"General transcription factor II-I"	"GTF2I"
"T-complex protein 1 subunit beta"	"CCT2"
"Glutathione S-transferase omega-1"	"GSTO1"
"DNA-dependent protein kinase catalytic subunit"	"PRKDC"
"Brain acid soluble protein 1"	"BASP1"
"SAP domain-containing ribonucleoprotein"	"SARNP"
"Chromobox protein homolog 1"	"CBX1"
"ADP-ribosylation factor 1;ADP-ribosylation factor 3"	"ARF1"
"ADP-ribosylation factor 5"	"ARF5"
"Enhancer of rudimentary homolog"	"ERH"
"Forkhead box protein K1"	"FOXK1"
"RNA-binding protein 10"	"RBM10"
"RNA-binding protein 3"	"RBM3"
"Transcription factor A, mitochondrial"	"TFAM"
"Cyclin-dependent kinase 6"	"CDK6"
"Peptidyl-prolyl cis-trans isomerase FKBP3"	"FKBP3"
"Sorbitol dehydrogenase"	"SORD"
"Heterogeneous nuclear ribonucleoprotein U"	"HNRNPU"
"Nucleolysin TIAR"	"TIAL1"
"Fatty acid-binding protein, epidermal"	"FABP5"
"Adenylyl cyclase-associated protein 1;Adenylyl cyclase-associated protein"	"CAP1"
"Hydroxymethylglutaryl-CoA synthase, cytoplasmic"	"HMGCS1"
"Protein Dr1"	"DR1"
"ATP-dependent 6-phosphofructokinase, platelet type"	"PFKP"
"Methylmalonate-semialdehyde dehydrogenase [acylating], mitochondrial"	"ALDH6A1"
"Dual specificity mitogen-activated protein kinase kinase 1;Dual specificity mitogen-activated protein kinase kinase 2"	"MAP2K1"
"Peptidyl-prolyl cis-trans isomerase FKBP4;Peptidyl-prolyl cis-trans isomerase FKBP4, N-terminally processed"	"FKBP4"
"Procollagen-lysine,2-oxoglutarate 5-dioxygenase 1"	"PLOD1"
"Nucleobindin-1"	"NUCB1"
"60S ribosomal protein L6"	"RPL6"
"DNA topoisomerase 2-beta;DNA topoisomerase 2"	"TOP2B"
"A-kinase anchor protein 12"	"AKAP12"
"Lamin-B2"	"LMNB2"
"Transducin-like enhancer protein 1;Transducin-like enhancer protein 2;Transducin-like enhancer protein 4"	"TLE1"
"Lactoylglutathione lyase"	"GLO1"
"Single-stranded DNA-binding protein, mitochondrial"	"SSBP1"
"14-3-3 protein eta"	"YWHAH"
"Cleavage stimulation factor subunit 1"	"CSTF1"
"Serine/arginine-rich splicing factor 11"	"SRSF11"
"Tyrosine-protein phosphatase non-receptor type 11"	"PTPN11"
"Amidophosphoribosyltransferase"	"PPAT"
"Glutamine--fructose-6-phosphate aminotransferase [isomerizing] 1"	"GFPT1"
"Proteasome activator complex subunit 1"	"PSME1"
"Peroxiredoxin-1"	"PRDX1"
"Complement component 1 Q subcomponent-binding protein, mitochondrial"	"C1QBP"
"Cytoskeleton-associated protein 4"	"CKAP4"
"KH domain-containing, RNA-binding, signal transduction-associated protein 1"	"KHDRBS1"
"Apoptosis regulator BAX"	"BAX"
"Prolow-density lipoprotein receptor-related protein 1;Low-density lipoprotein receptor-related protein 1 85 kDa subunit;Low-density lipoprotein receptor-related protein 1 515 kDa subunit;Low-density lipoprotein receptor-related protein 1 intracellular domain"	"LRP1"
"Rho GTPase-activating protein 1"	"ARHGAP1"
"ATP-dependent RNA helicase A"	"DHX9"
"Quinone oxidoreductase"	"CRYZ"
"Galectin-3-binding protein"	"LGALS3BP"
"Peptidyl-prolyl cis-trans isomerase D"	"PPID"
"FACT complex subunit SSRP1"	"SSRP1"
"tRNA (cytosine(34)-C(5))-methyltransferase"	"NSUN2"
"Histone-binding protein RBBP4"	"RBBP4"
"Nuclear cap-binding protein subunit 1"	"NCBP1"
"Neuroblast differentiation-associated protein AHNAK"	"AHNAK"
"Ragulator complex protein LAMTOR4;Ragulator complex protein LAMTOR4, N-terminally processed"	"LAMTOR4"
"Polypeptide N-acetylgalactosaminyltransferase 2;Polypeptide N-acetylgalactosaminyltransferase 2 soluble form"	"GALNT2"
"Cleavage and polyadenylation specificity factor subunit 1"	"CPSF1"
"Mitochondrial-processing peptidase subunit alpha"	"PMPCA"
"Secernin-1"	"SCRN1"
"Aspartyl/asparaginyl beta-hydroxylase"	"ASPH"
"Alpha-globin transcription factor CP2"	"TFCP2"
"Splicing factor 3A subunit 3"	"SF3A3"
"Aminoacyl tRNA synthase complex-interacting multifunctional protein 1;Endothelial monocyte-activating polypeptide 2"	"AIMP1"
"Interleukin enhancer-binding factor 2"	"ILF2"
"Interleukin enhancer-binding factor 3"	"ILF3"
"Heat shock protein 75 kDa, mitochondrial"	"TRAP1"
"Nuclear inhibitor of protein phosphatase 1;Activator of RNA decay"	"PPP1R8"
"Delta(3,5)-Delta(2,4)-dienoyl-CoA isomerase, mitochondrial"	"ECH1"
"Protein AF1q"	"MLLT11"
"Protein Red"	"IK"
"TAR DNA-binding protein 43"	"TARDBP"
"Heterogeneous nuclear ribonucleoprotein A0"	"HNRNPA0"
"Aminoacyl tRNA synthase complex-interacting multifunctional protein 2"	"AIMP2"
"Peroxiredoxin-4"	"PRDX4"
"Serine/threonine-protein kinase PAK 2;PAK-2p27;PAK-2p34"	"PAK2"
"Chromobox protein homolog 3"	"CBX3"
"26S proteasome non-ATPase regulatory subunit 2"	"PSMD2"
"Selenium-binding protein 1"	"SELENBP1"
"Serine/arginine-rich splicing factor 9"	"SRSF9"
"Serine/arginine-rich splicing factor 5"	"SRSF5"
"Serine/arginine-rich splicing factor 6"	"SRSF6"
"Transcription intermediary factor 1-beta"	"TRIM28"
"Ras GTPase-activating protein-binding protein 1"	"G3BP1"
"Inactive tyrosine-protein kinase 7"	"PTK7"
"Eukaryotic translation initiation factor 3 subunit I"	"EIF3I"
"C-terminal-binding protein 1"	"CTBP1"
"Ubiquitin-conjugating enzyme E2 variant 1"	"UBE2V1"
"Cytoplasmic dynein 1 intermediate chain 2"	"DYNC1I2"
"NAD(P) transhydrogenase, mitochondrial"	"NNT"
"Splicing factor 3B subunit 2"	"SF3B2"
"28 kDa heat- and acid-stable phosphoprotein"	"PDAP1"
"Phosphatidylinositol-binding clathrin assembly protein;Clathrin coat assembly protein AP180"	"PICALM"
"Metaxin-1"	"MTX1"
"Tubulin beta-3 chain"	"TUBB3"
"Serine/threonine-protein kinase PRP4 homolog"	"PRPF4B"
"Peptidyl-prolyl cis-trans isomerase NIMA-interacting 1"	"PIN1"
"Eukaryotic translation initiation factor 4E-binding protein 2"	"EIF4EBP2"
"Dynactin subunit 2"	"DCTN2"
"NEDD8-activating enzyme E1 regulatory subunit"	"NAE1"
"SNW domain-containing protein 1"	"SNW1"
"Transformer-2 protein homolog alpha"	"TRA2A"
"Sorting nexin-1"	"SNX1"
"KRR1 small subunit processome component homolog"	"KRR1"
"Cullin-1"	"CUL1"
"Cullin-3"	"CUL3"
"Trophoblast glycoprotein"	"TPBG"
"Spliceosome RNA helicase DDX39B"	"DDX39B"
"Bleomycin hydrolase"	"BLMH"
"Exosome complex component RRP4"	"EXOSC2"
"Tubulin beta-2A chain"	"TUBB2A"
"Isopentenyl-diphosphate Delta-isomerase 1"	"IDI1"
"Cytoskeleton-associated protein 5"	"CKAP5"
"Cold-inducible RNA-binding protein"	"CIRBP"
"Coactosin-like protein"	"COTL1"
"Heterogeneous nuclear ribonucleoprotein D0"	"HNRNPD"
"Scaffold attachment factor B2"	"SAFB2"
"Eukaryotic translation initiation factor 3 subunit A"	"EIF3A"
"Malectin"	"MLEC"
"Tubulin--tyrosine ligase-like protein 12"	"TTLL12"
"Dihydropyrimidinase-related protein 1"	"CRMP1"
"Dihydropyrimidinase-related protein 3"	"DPYSL3"
"Cytoplasmic dynein 1 heavy chain 1"	"DYNC1H1"
"Eukaryotic initiation factor 4A-II;Eukaryotic initiation factor 4A-II, N-terminally processed"	"EIF4A2"
"Src substrate cortactin"	"CTTN"
"Reticulocalbin-2"	"RCN2"
"Filamin-C"	"FLNC"
"Peptidyl-prolyl cis-trans isomerase FKBP8;Peptidyl-prolyl cis-trans isomerase"	"FKBP8"
"Protein FAM50A"	"FAM50A"
"Protein FRG1"	"FRG1"
"RNA-binding protein 39"	"RBM39"
"DNA replication licensing factor MCM6"	"MCM6"
"ELAV-like protein 3"	"ELAVL3"
"Clathrin interactor 1"	"CLINT1"
"Structural maintenance of chromosomes protein 1A;Structural maintenance of chromosomes protein"	"SMC1A"
"Ribosomal RNA processing protein 1 homolog B"	"RRP1B"
"Ubiquitin carboxyl-terminal hydrolase 10"	"USP10"
"LDLR chaperone MESD"	"MESDC2"
"Neutral alpha-glucosidase AB"	"GANAB"
"LIM and SH3 domain protein 1"	"LASP1"
"Ketimine reductase mu-crystallin"	"CRYM"
"Importin subunit beta-1"	"KPNB1"
"Nuclear mitotic apparatus protein 1"	"NUMA1.1"
"Pre-mRNA-splicing regulator WTAP"	"WTAP"
"26S proteasome non-ATPase regulatory subunit 6"	"PSMD6"
"Septin-2"	"X2.Sep"
"116 kDa U5 small nuclear ribonucleoprotein component"	"EFTUD2"
"Rab3 GTPase-activating protein catalytic subunit"	"RAB3GAP1"
"Lysine--tRNA ligase"	"KARS"
"DNA polymerase delta subunit 3"	"POLD3"
"Eukaryotic translation initiation factor 4H"	"EIF4H"
"Protein disulfide-isomerase A6"	"PDIA6"
"Platelet-activating factor acetylhydrolase IB subunit gamma"	"PAFAH1B3"
"Astrocytic phosphoprotein PEA-15"	"PEA15"
"Phosphomevalonate kinase"	"PMVK"
"Plectin"	"PLEC"
"Inorganic pyrophosphatase"	"PPA1"
"Non-POU domain-containing octamer-binding protein"	"NONO"
"Reticulocalbin-1"	"RCN1"
"Poly(rC)-binding protein 1"	"PCBP1"
"Poly(rC)-binding protein 2"	"PCBP2.2"
"Splicing factor 3B subunit 3"	"SF3B3"
"Calponin-3;Calponin"	"CNN3"
"Scaffold attachment factor B1"	"SAFB"
"Splicing factor 3B subunit 4"	"SF3B4"
"Splicing factor 3A subunit 2"	"SF3A2"
"Splicing factor 3A subunit 1"	"SF3A1"
"Microtubule-associated protein RP/EB family member 2"	"MAPRE2"
"Splicing factor 1"	"SF1"
"Microtubule-associated protein RP/EB family member 1"	"MAPRE1"
"ELAV-like protein 1"	"ELAVL1"
"Sterol-4-alpha-carboxylate 3-dehydrogenase, decarboxylating"	"NSDHL"
"TGF-beta-activated kinase 1 and MAP3K7-binding protein 1"	"TAB1"
"Mitochondrial import receptor subunit TOM34"	"TOMM34"
"Ubiquitin-conjugating enzyme E2 variant 2"	"UBE2V2"
"NEDD8"	"NEDD8"
"Ras-related protein Rab-11B;Ras-related protein Rab-11A"	"RAB11B"
"Proteasomal ubiquitin receptor ADRM1"	"ADRM1"
"Coiled-coil domain-containing protein 6"	"CCDC6"
"Alpha-internexin"	"INA"
"26S proteasome non-ATPase regulatory subunit 5"	"PSMD5"
"Cysteine and glycine-rich protein 2"	"CSRP2"
"DNA damage-binding protein 1"	"DDB1"
"Histone-binding protein RBBP7"	"RBBP7"
"Drebrin"	"DBN1"
"Fascin"	"FSCN1"
"2,4-dienoyl-CoA reductase, mitochondrial"	"DECR1"
"Thiosulfate sulfurtransferase"	"TST"
"Reticulon-1;Reticulon"	"RTN1"
"Heterogeneous nuclear ribonucleoprotein U-like protein 2"	"HNRNPUL2"
"Sister chromatid cohesion protein PDS5 homolog A"	"PDS5A"
"Glutamine-rich protein 1"	"QRICH1"
"WD40 repeat-containing protein SMU1;WD40 repeat-containing protein SMU1, N-terminally processed"	"SMU1"
"Prolyl 3-hydroxylase 1"	"LEPRE1"
"Nucleoside diphosphate kinase;Nucleoside diphosphate kinase B"	"NME1.NME2"
"Inactive hydroxysteroid dehydrogenase-like protein 1"	"HSDL1"
"Tubulin beta-8 chain"	"TUBB8"
"NAD kinase 2, mitochondrial"	"NADK2"
"Prolyl endopeptidase-like"	"PREPL"
"Protein FAM98B"	"FAM98B"
"Programmed cell death protein 4"	"PDCD4"
"Very-long-chain 3-oxoacyl-CoA reductase"	"HSD17B12"
"Putative heat shock protein HSP 90-beta 2"	"HSP90AB2P"
"DBIRD complex subunit ZNF326"	"ZNF326"
"Zinc finger protein 789"	"ZNF789"
"Protein crumbs homolog 2"	"CRB2"
"Crooked neck-like protein 1"	"CRNKL1"
"Alpha-tubulin N-acetyltransferase 1"	"ATAT1"
"Nucleoporin NUP188 homolog"	"NUP188"
"Heterochromatin protein 1-binding protein 3"	"HP1BP3"
"Centrosomal protein of 170 kDa"	"CEP170"
"Zinc finger protein 362"	"ZNF362"
"SH3 domain-binding glutamic acid-rich-like protein 3"	"SH3BGRL3"
"Xaa-Pro aminopeptidase 1"	"XPNPEP1"
"Histone H3"	"HIST2H3PS2"
"Glycerol-3-phosphate acyltransferase 1, mitochondrial"	"GPAM"
"Microtubule-associated protein 1S;MAP1S heavy chain;MAP1S light chain"	"MAP1S"
"Integrator complex subunit 3"	"INTS3"
"Rho GTPase-activating protein 17"	"ARHGAP17"
"Protein virilizer homolog"	"KIAA1429"
"Nucleoredoxin"	"NXN"
"Histone H2A type 2-A;Histone H2A type 2-C"	"HIST2H2AA3"
"Anamorsin"	"CIAPIN1"
"Putative peptidyl-tRNA hydrolase PTRHD1"	"PTRHD1"
"Ragulator complex protein LAMTOR1"	"LAMTOR1"
"Twinfilin-2"	"TWF2"
"Calcium-binding mitochondrial carrier protein SCaMC-1"	"SLC25A24"
"3-hydroxyisobutyryl-CoA hydrolase, mitochondrial"	"HIBCH"
"Pre-mRNA-processing-splicing factor 8"	"PRPF8"
"Acylpyruvase FAHD1, mitochondrial"	"FAHD1"
"TLD domain-containing protein 1"	"TLDC1"
"POTE ankyrin domain family member E;POTE ankyrin domain family member F;POTE ankyrin domain family member I"	"POTEE"
"WD repeat-containing protein 82"	"WDR82"
"Hydroxysteroid dehydrogenase-like protein 2"	"HSDL2"
"Tubulin alpha-1A chain"	"TUBA1A"
"Transcription elongation factor SPT6"	"SUPT6H"
"Staphylococcal nuclease domain-containing protein 1"	"SND1"
"Protein RUFY3"	"RUFY3"
"Mitochondrial ribonuclease P protein 1"	"TRMT10C"
"Eukaryotic translation initiation factor 3 subunit M"	"EIF3M"
"EPM2A-interacting protein 1"	"EPM2AIP1"
"MOB kinase activator 1B;MOB kinase activator 1A"	"MOB1B"
"Lysine-specific demethylase 3B"	"KDM3B"
"Class A basic helix-loop-helix protein 15"	"BHLHA15"
"PHD finger-like domain-containing protein 5A"	"PHF5A"
"Nucleoporin p54"	"NUP54"
"Pogo transposable element with ZNF domain"	"POGZ"
"Myosin-14"	"MYH14"
"KDEL motif-containing protein 2"	"KDELC2"
"Hepatoma-derived growth factor-related protein 2"	"HDGFRP2"
"E3 ubiquitin-protein ligase HUWE1"	"HUWE1"
"Centromere protein V"	"CENPV"
"Polyadenylate-binding protein 2"	"PABPN1"
"Protein LYRIC"	"MTDH"
"Kinectin"	"KTN1"
"THO complex subunit 4"	"ALYREF"
"Cullin-associated NEDD8-dissociated protein 1"	"CAND1"
"Protein Hook homolog 3"	"HOOK3"
"Histone-arginine methyltransferase CARM1"	"CARM1"
"Nitrilase homolog 1"	"NIT1"
"ATP-dependent RNA helicase DDX42"	"DDX42"
"Transcriptional repressor p66-alpha"	"GATAD2A"
"Histone H2A type 2-B"	"HIST2H2AB"
"Phospholipase D3"	"PLD3"
"Calcium homeostasis endoplasmic reticulum protein"	"CHERP"
"Cell division cycle and apoptosis regulator protein 1"	"CCAR1"
"DnaJ homolog subfamily C member 10"	"DNAJC10"
"REST corepressor 2"	"RCOR2"
"Cell cycle and apoptosis regulator protein 2"	"CCAR2"
"Nuclear pore complex protein Nup93"	"NUP93"
"Leucine-rich repeat-containing protein 47"	"LRRC47"
"39S ribosomal protein L50, mitochondrial"	"MRPL50"
"Cleavage and polyadenylation specificity factor subunit 7"	"CPSF7"
"ER membrane protein complex subunit 1"	"EMC1"
"RNA polymerase II-associated factor 1 homolog"	"PAF1"
"Putative E3 ubiquitin-protein ligase UBR7"	"UBR7"
"Pre-mRNA-splicing factor 38A"	"PRPF38A"
"Procollagen galactosyltransferase 1"	"COLGALT1"
"Prenylcysteine oxidase-like"	"PCYOX1L"
"Thioredoxin domain-containing protein 5"	"TXNDC5"
"Plasminogen activator inhibitor 1 RNA-binding protein"	"SERBP1"
"Protein LSM14 homolog A"	"LSM14A"
"MAPK-interacting and spindle-stabilizing protein-like"	"MAPK1IP1L"
"Putative RNA-binding protein 15B"	"RBM15B"
"ATP-binding cassette sub-family F member 1"	"ABCF1"
"Nucleoporin Nup43"	"NUP43"
"N-acylneuraminate cytidylyltransferase"	"CMAS"
"Anaphase-promoting complex subunit CDC26"	"CDC26"
"Nuclear protein localization protein 4 homolog"	"NPLOC4"
"NEDD8-activating enzyme E1 catalytic subunit"	"UBA3"
"Retinol dehydrogenase 11"	"RDH11"
"Dolichyl-diphosphooligosaccharide--protein glycosyltransferase subunit STT3B"	"STT3B"
"Nuclear pore membrane glycoprotein 210"	"NUP210"
"Nucleolar complex protein 3 homolog"	"NOC3L"
"Peptidyl-prolyl cis-trans isomerase-like 4"	"PPIL4"
"PHD finger protein 10"	"PHF10"
"Nuclear pore complex protein Nup133"	"NUP133"
"Programmed cell death 6-interacting protein"	"PDCD6IP"
"NudC domain-containing protein 2"	"NUDCD2"
"Sec1 family domain-containing protein 1"	"SCFD1"
"Ubiquitin-like domain-containing CTD phosphatase 1"	"UBLCP1"
"PEST proteolytic signal-containing nuclear protein"	"PCNP"
"Ataxin-2-like protein"	"ATXN2L"
"PH-interacting protein"	"PHIP"
"Splicing regulatory glutamine/lysine-rich protein 1"	"SREK1.1"
"Paraspeckle component 1"	"PSPC1"
"Nesprin-2"	"SYNE2"
"DnaJ homolog subfamily C member 9"	"DNAJC9"
"Protein LZIC"	"LZIC"
"Immunity-related GTPase family Q protein"	"IRGQ"
"Histone H1x"	"H1FX"
"T-complex protein 1 subunit zeta-2"	"CCT6B"
"Heat shock protein 105 kDa"	"HSPH1"
"Translational activator GCN1"	"GCN1L1"
"Pre-mRNA-splicing factor ATP-dependent RNA helicase PRP16"	"DHX38"
"Nuclear pore complex protein Nup205"	"NUP205"
"Acidic leucine-rich nuclear phosphoprotein 32 family member B"	"ANP32B"
"Protein TFG"	"TFG"
"Actin-related protein 2/3 complex subunit 1A"	"ARPC1A"
"Histone deacetylase 2;Histone deacetylase 1"	"HDAC2"
"Signal transducing adapter molecule 1;Signal transducing adapter molecule 2"	"STAM"
"Gamma-glutamyl hydrolase"	"GGH"
"Golgi apparatus protein 1"	"GLG1"
"Regulator of nonsense transcripts 1"	"UPF1"
"COP9 signalosome complex subunit 5"	"COPS5"
"SWI/SNF complex subunit SMARCC1"	"SMARCC1"
"Far upstream element-binding protein 2"	"KHSRP"
"Glutaryl-CoA dehydrogenase, mitochondrial"	"GCDH"
"Transportin-1"	"TNPO1"
"Probable ubiquitin carboxyl-terminal hydrolase FAF-X;Probable ubiquitin carboxyl-terminal hydrolase FAF-Y"	"USP9X"
"Cullin-5"	"CUL5"
"Protein mago nashi homolog 2"	"MAGOHB"
"Isochorismatase domain-containing protein 2, mitochondrial"	"ISOC2"
"Leucine-rich repeat-containing protein 59"	"LRRC59"
"Ribulose-phosphate 3-epimerase;Ribulose-phosphate 3-epimerase-like protein 1"	"RPE"
"Peptidyl-prolyl cis-trans isomerase FKBP10;Peptidyl-prolyl cis-trans isomerase"	"FKBP10"
"ADP-ribosylation factor-like protein 8A"	"ARL8A"
"Aldose 1-epimerase"	"GALM"
"Protein phosphatase 1 regulatory subunit 14B"	"PPP1R14B"
"Acyl-CoA synthetase family member 2, mitochondrial"	"ACSF2"
"Isochorismatase domain-containing protein 1"	"ISOC1"
"FAS-associated factor 2"	"FAF2"
"Coiled-coil domain-containing protein 124"	"CCDC124"
"BTB/POZ domain-containing protein KCTD12"	"KCTD12"
"U8 snoRNA-decapping enzyme"	"NUDT16"
"Carboxymethylenebutenolidase homolog"	"CMBL"
"U5 small nuclear ribonucleoprotein 40 kDa protein"	"SNRNP40"
"Dynein light chain 2, cytoplasmic"	"DYNLL2"
"SWI/SNF-related matrix-associated actin-dependent regulator of chromatin subfamily D member 1"	"SMARCD1"
"Zinc finger CCCH-type antiviral protein 1-like"	"ZC3HAV1L"
"PDZ and LIM domain protein 5"	"PDLIM5"
"ERO1-like protein alpha"	"ERO1L"
"Far upstream element-binding protein 3"	"FUBP3"
"Splicing factor 45"	"RBM17"
"Succinyl-CoA ligase [GDP-forming] subunit beta, mitochondrial"	"SUCLG2"
"Up-regulated during skeletal muscle growth protein 5"	"USMG5"
"Chromosome alignment-maintaining phosphoprotein 1"	"CHAMP1"
"Transcription factor BTF3 homolog 4;Transcription factor BTF3"	"BTF3L4"
"Ubiquitin carboxyl-terminal hydrolase 47"	"USP47"
"Cytosolic non-specific dipeptidase"	"CNDP2"
"Protein PRRC1"	"PRRC1"
"Dynein heavy chain domain-containing protein 1"	"DNHD1"
"Importin-9"	"IPO9"
"RNA-binding protein 14"	"RBM14"
"E3 ubiquitin-protein ligase UHRF2"	"UHRF2"
"Protein quaking"	"QKI"
"CCA tRNA nucleotidyltransferase 1, mitochondrial"	"TRNT1"
"Kinesin-like protein KIF20B"	"KIF20B"
"Serine/threonine-protein phosphatase 1 regulatory subunit 10"	"PPP1R10"
"Vacuolar protein sorting-associated protein 35"	"VPS35"
"Glutathione peroxidase 7"	"GPX7"
"Paired amphipathic helix protein Sin3a"	"SIN3A"
"Remodeling and spacing factor 1"	"RSF1"
"Tubulin-folding cofactor B"	"TBCB"
"Proteasome subunit beta type-7"	"PSMB7"
"Cell division cycle 5-like protein"	"CDC5L"
"Prefoldin subunit 5"	"PFDN5"
"E3 ubiquitin-protein ligase RING2"	"RNF2"
"Protein deglycase DJ-1"	"PARK7"
"Synaptic vesicle membrane protein VAT-1 homolog"	"VAT1"
"Eukaryotic translation initiation factor 3 subunit C;Eukaryotic translation initiation factor 3 subunit C-like protein"	"EIF3C"
"Prohibitin-2"	"PHB2"
"3-hydroxyacyl-CoA dehydrogenase type-2"	"HSD17B10"
"Nucleosome assembly protein 1-like 4"	"NAP1L4"
"T-complex protein 1 subunit eta"	"CCT7"
"Endophilin-A2"	"SH3GL1"
"Serine/threonine-protein kinase VRK1"	"VRK1"
"Dihydropyrimidinase-related protein 5"	"DPYSL5"
"Protein NipSnap homolog 1"	"NIPSNAP1"
"ATP-dependent RNA helicase DDX50"	"DDX50"
"O-acetyl-ADP-ribose deacetylase MACROD1"	"MACROD1"
"Methylosome protein 50"	"WDR77"
"Coronin-1B;Coronin"	"CORO1B"
"Thioredoxin domain-containing protein 17"	"TXNDC17"
"Vacuolar protein-sorting-associated protein 25"	"VPS25"
"Redox-regulatory protein FAM213A"	"FAM213A"
"Endoplasmic reticulum resident protein 44"	"ERP44"
"Extended synaptotagmin-1"	"ESYT1"
"Protein canopy homolog 3"	"CNPY3"
"Acidic leucine-rich nuclear phosphoprotein 32 family member E"	"ANP32E"
"Transmembrane protein 43"	"TMEM43"
"Tubulin beta-6 chain"	"TUBB6"
"Protein PAXX"	"C9orf142"
"Probable ATP-dependent RNA helicase DDX23"	"DDX23"
"3-hydroxybutyrate dehydrogenase type 2"	"BDH2"
"1,2-dihydroxy-3-keto-5-methylthiopentene dioxygenase"	"ADI1"
"N-terminal Xaa-Pro-Lys N-methyltransferase 1;N-terminal Xaa-Pro-Lys N-methyltransferase 1, N-terminally processed"	"NTMT1"
"Tubulin beta-2B chain"	"TUBB2B"
"Transmembrane protein 109"	"TMEM109"
"Protein PBDC1"	"PBDC1"
"Transmembrane emp24 domain-containing protein 9"	"TMED9"
"Tubulin polymerization-promoting protein family member 3"	"TPPP3"
"Acetyl-CoA acetyltransferase, cytosolic"	"ACAT2"
"RNA-binding protein 4"	"RBM4"
"Splicing factor 3B subunit 5"	"SF3B5"
"Protein LSM14 homolog B"	"LSM14B"
"Histidine triad nucleotide-binding protein 2, mitochondrial"	"HINT2"
"Serrate RNA effector molecule homolog"	"SRRT"
"Cat eye syndrome critical region protein 5"	"CECR5"
"Inosine triphosphate pyrophosphatase"	"ITPA"
"YTH domain-containing family protein 1;YTH domain-containing family protein 3"	"YTHDF1"
"Oxysterol-binding protein-related protein 8;Oxysterol-binding protein"	"OSBPL8"
"F-box-like/WD repeat-containing protein TBL1XR1"	"TBL1XR1"
"Protein dpy-30 homolog"	"DPY30"
"182 kDa tankyrase-1-binding protein"	"TNKS1BP1"
"E2/E3 hybrid ubiquitin-protein ligase UBE2O"	"UBE2O"
"Protein lunapark"	"LNP"
"Ribosome biogenesis protein WDR12"	"WDR12"
"UPF0687 protein C20orf27"	"C20orf27"
"PITH domain-containing protein 1"	"PITHD1"
"WD repeat-containing protein 61;WD repeat-containing protein 61, N-terminally processed"	"WDR61"
"Serine racemase"	"SRR"
"Integrin-linked kinase-associated serine/threonine phosphatase 2C"	"ILKAP"
"5-3 exoribonuclease 2"	"XRN2"
"Ras-related protein Rab-1B"	"RAB1B"
"Interferon regulatory factor 2-binding protein-like"	"IRF2BPL"
"Nuclear ubiquitous casein and cyclin-dependent kinase substrate 1"	"NUCKS1"
"Thioredoxin-related transmembrane protein 4"	"TMX4"
"Rab3 GTPase-activating protein non-catalytic subunit"	"RAB3GAP2"
"Activity-dependent neuroprotector homeobox protein"	"ADNP"
"Inorganic pyrophosphatase 2, mitochondrial"	"PPA2"
"Pinin"	"PNN"
"BolA-like protein 2"	"BOLA2"
"Thioredoxin-related transmembrane protein 1"	"TMX1"
"Cdc42 effector protein 4"	"CDC42EP4"
"Charged multivesicular body protein 4b"	"CHMP4B"
"GDP-fucose protein O-fucosyltransferase 1"	"POFUT1"
"dCTP pyrophosphatase 1"	"DCTPP1"
"Acyl-CoA dehydrogenase family member 9, mitochondrial"	"ACAD9"
"5-nucleotidase domain-containing protein 2"	"NT5DC2"
"Golgi reassembly-stacking protein 2"	"GORASP2"
"Leucine-rich repeat-containing protein 40"	"LRRC40"
"Sideroflexin-1"	"SFXN1"
"Protein argonaute-3;Protein argonaute-2;Protein argonaute;Protein argonaute-1"	"AGO3"
"Exportin-5"	"XPO5"
"GrpE protein homolog 1, mitochondrial"	"GRPEL1"
"UPF0160 protein MYG1, mitochondrial"	"C12orf10"
"Calcyclin-binding protein"	"CACYBP"
"Synaptic vesicle membrane protein VAT-1 homolog-like"	"VAT1L"
"Transmembrane 9 superfamily member 3"	"TM9SF3"
"Adipocyte plasma membrane-associated protein"	"APMAP"
"High mobility group protein 20A"	"HMG20A"
"Ras-related protein Rab-18"	"RAB18"
"RNA polymerase II subunit A C-terminal domain phosphatase SSU72"	"SSU72"
"Dynein light chain roadblock-type 1;Dynein light chain roadblock-type 2"	"DYNLRB1"
"Transcription and mRNA export factor ENY2"	"ENY2"
"Exosome complex component RRP41"	"EXOSC4"
"Inositol-3-phosphate synthase 1"	"ISYNA1"
"Acyl-coenzyme A thioesterase 13;Acyl-coenzyme A thioesterase 13, N-terminally processed"	"ACOT13"
"Putative RNA-binding protein Luc7-like 1"	"LUC7L"
"Leucine zipper transcription factor-like protein 1"	"LZTFL1"
"Fructose-2,6-bisphosphatase TIGAR"	"TIGAR"
"Reticulon-4"	"RTN4"
"Regulation of nuclear pre-mRNA domain-containing protein 1B"	"RPRD1B"
"Omega-amidase NIT2"	"NIT2"
"Nucleolar RNA helicase 2"	"DDX21"
"GTP-binding protein SAR1a"	"SAR1A"
"Sialic acid synthase"	"NANS"
"CTP synthase 2"	"CTPS2"
"DNA polymerase epsilon subunit 3"	"POLE3"
"L-aminoadipate-semialdehyde dehydrogenase-phosphopantetheinyl transferase"	"AASDHPPT"
"Ubiquilin-4"	"UBQLN4"
"14 kDa phosphohistidine phosphatase"	"PHPT1"
"Phenylalanine--tRNA ligase beta subunit"	"FARSB"
"Isoleucine--tRNA ligase, mitochondrial"	"IARS2"
"Sister chromatid cohesion protein PDS5 homolog B"	"PDS5B"
"RNA-binding protein 12"	"RBM12"
"Mycophenolic acid acyl-glucuronide esterase, mitochondrial"	"ABHD10"
"ATP-dependent RNA helicase DDX19A;ATP-dependent RNA helicase DDX19B"	"DDX19A"
"TBC1 domain family member 13"	"TBC1D13"
"ATPase family AAA domain-containing protein 3A;ATPase family AAA domain-containing protein 3C"	"ATAD3A"
"ADP-ribosylation factor-like protein 8B"	"ARL8B"
"ATP-dependent RNA helicase DDX18"	"DDX18"
"Pre-mRNA-splicing factor RBM22"	"RBM22"
"SAFB-like transcription modulator"	"SLTM"
"UPF0587 protein C1orf123"	"C1orf123"
"UPF0609 protein C4orf27"	"C4orf27"
"OCIA domain-containing protein 1"	"OCIAD1"
"Poly(ADP-ribose) glycohydrolase ARH3"	"ADPRHL2"
"Testis-expressed sequence 10 protein"	"TEX10"
"THUMP domain-containing protein 1"	"THUMPD1"
"H/ACA ribonucleoprotein complex subunit 1"	"GAR1"
"Telomeric repeat-binding factor 2-interacting protein 1"	"TERF2IP"
"Bcl-2-associated transcription factor 1"	"BCLAF1"
"39S ribosomal protein L39, mitochondrial"	"MRPL39"
"UDP-glucose:glycoprotein glucosyltransferase 1"	"UGGT1"
"Insulin-like growth factor 2 mRNA-binding protein 1"	"IGF2BP1"
"Hsp70-binding protein 1"	"HSPBP1"
"Methionine adenosyltransferase 2 subunit beta"	"MAT2B"
"Spliceosome-associated protein CWC15 homolog"	"CWC15"
"39S ribosomal protein L15, mitochondrial"	"MRPL15"
"Very-long-chain (3R)-3-hydroxyacyl-CoA dehydratase 3"	"HACD3"
"NADH dehydrogenase [ubiquinone] 1 alpha subcomplex subunit 13"	"NDUFA13"
"Vesicle-associated membrane protein-associated protein A"	"VAPA"
"Core histone macro-H2A.2;Histone H2A"	"H2AFY2"
"Costars family protein ABRACL"	"ABRACL"
"Protein RCC2"	"RCC2"
"Ribosome-binding protein 1"	"RRBP1"
"Cleavage and polyadenylation specificity factor subunit 2"	"CPSF2"
"Leucine--tRNA ligase, cytoplasmic"	"LARS"
"Rabankyrin-5"	"ANKFY1"
"Ataxin-10"	"ATXN10"
"SUMO-activating enzyme subunit 1;SUMO-activating enzyme subunit 1, N-terminally processed"	"SAE1"
"Coatomer subunit gamma-2"	"COPG2"
"COMM domain-containing protein 3"	"COMMD3"
"7-dehydrocholesterol reductase"	"DHCR7"
"Glyoxylate reductase/hydroxypyruvate reductase"	"GRHPR"
"DnaJ homolog subfamily B member 11"	"DNAJB11"
"SUMO-activating enzyme subunit 2"	"UBA2"
"Peflin"	"PEF1"
"CAP-Gly domain-containing linker protein 2"	"CLIP2"
"Craniofacial development protein 1"	"CFDP1"
"Gamma-adducin"	"ADD3"
"Translocation protein SEC63 homolog"	"SEC63"
"SUN domain-containing protein 2"	"SUN2"
"Ragulator complex protein LAMTOR3"	"LAMTOR3"
"Signal recognition particle subunit SRP68"	"SRP68"
"Cysteine and histidine-rich domain-containing protein 1"	"CHORDC1"
"Septin-9"	"X9.Sep"
"Ubiquilin-2"	"UBQLN2"
"Prenylcysteine oxidase 1"	"PCYOX1"
"Prefoldin subunit 2"	"PFDN2"
"Transgelin-3"	"TAGLN3"
"Tyrosine-protein kinase BAZ1B"	"BAZ1B"
"ATPase inhibitor, mitochondrial"	"ATPIF1"
"GTP:AMP phosphotransferase AK3, mitochondrial"	"AK3"
"Calcium-binding mitochondrial carrier protein Aralar2"	"SLC25A13"
"Drebrin-like protein"	"DBNL"
"Stomatin-like protein 2, mitochondrial"	"STOML2"
"Polypyrimidine tract-binding protein 2"	"PTBP2"
"mRNA turnover protein 4 homolog"	"MRTO4"
"Cleavage and polyadenylation specificity factor subunit 3"	"CPSF3"
"DCC-interacting protein 13-alpha"	"APPL1"
"RNA-binding protein Raly"	"RALY"
"Nuclear pore complex protein Nup50"	"NUP50"
"Protein CDV3 homolog"	"CDV3"
"Ras-related protein Rab-21"	"RAB21"
"Coronin-1C;Coronin"	"CORO1C"
"Pre-mRNA-processing factor 19"	"PRPF19"
"Ubiquilin-1"	"UBQLN1"
"Ras GTPase-activating protein-binding protein 2"	"G3BP2"
"E3 ubiquitin-protein ligase CHIP"	"STUB1"
"Melanoma-associated antigen D2"	"MAGED2"
"26S proteasome non-ATPase regulatory subunit 13"	"PSMD13"
"COP9 signalosome complex subunit 3"	"COPS3"
"Multiple inositol polyphosphate phosphatase 1"	"MINPP1"
"RNA-binding protein Nova-2"	"NOVA2"
"WD repeat-containing protein 3"	"WDR3"
"NSFL1 cofactor p47"	"NSFL1C"
"E3 ubiquitin-protein ligase TRIM33"	"TRIM33"
"Serine/arginine repetitive matrix protein 2"	"SRRM2"
"Proliferation-associated protein 2G4"	"PA2G4"
"Structural maintenance of chromosomes protein 3"	"SMC3"
"UPF0568 protein C14orf166"	"C14orf166"
"RuvB-like 2"	"RUVBL2"
"RuvB-like 1"	"RUVBL1"
"Nuclear migration protein nudC"	"NUDC"
"Voltage-dependent anion-selective channel protein 3"	"VDAC3"
"Cofilin-2"	"CFL2"
"Histone chaperone ASF1A"	"ASF1A"
"Developmentally-regulated GTP-binding protein 1"	"DRG1"
"Protein canopy homolog 2"	"CNPY2"
"GDP-fucose protein O-fucosyltransferase 2"	"POFUT2"
"Exosome complex exonuclease RRP44"	"DIS3"
"Polymerase delta-interacting protein 2"	"POLDIP2"
"Calcium-regulated heat stable protein 1"	"CARHSP1"
"WW domain-binding protein 11"	"WBP11"
"Nucleolar protein 58"	"NOP58"
"Suppressor of G2 allele of SKP1 homolog"	"SUGT1"
"U6 snRNA-associated Sm-like protein LSm2"	"LSM2"
"Splicing factor 3B subunit 6"	"SF3B6"
"Ubiquitin-fold modifier-conjugating enzyme 1"	"UFC1"
"Mitochondrial fission 1 protein"	"FIS1"
"Serine-threonine kinase receptor-associated protein"	"STRAP"
"tRNA-splicing ligase RtcB homolog"	"RTCB"
"60S ribosomal protein L36"	"RPL36"
"Chromatin target of PRMT1 protein"	"CHTOP"
"Talin-1"	"TLN1"
"Talin-2"	"TLN2"
"Sorting and assembly machinery component 50 homolog"	"SAMM50"
"Intraflagellar transport protein 25 homolog"	"HSPB11"
"Protein phosphatase methylesterase 1"	"PPME1"
"YTH domain-containing family protein 2"	"YTHDF2"
"FACT complex subunit SPT16"	"SUPT16H"
"Mitochondrial import inner membrane translocase subunit Tim13"	"TIMM13"
"Mannose-1-phosphate guanyltransferase beta"	"GMPPB"
"RNA-binding protein 8A"	"RBM8A"
"Sorting nexin-5"	"SNX5"
"Heme-binding protein 2"	"HEBP2"
"Phosphoserine aminotransferase"	"PSAT1"
"Coatomer subunit gamma-1"	"COPG1"
"Peptidyl-prolyl cis-trans isomerase FKBP7"	"FKBP7"
"Chloride intracellular channel protein 4"	"CLIC4"
"Mitotic spindle assembly checkpoint protein MAD1"	"MAD1L1"
"Cytoplasmic dynein 1 light intermediate chain 1"	"DYNC1LI1"
"Coiled-coil-helix-coiled-coil-helix domain-containing protein 2;Putative coiled-coil-helix-coiled-coil-helix domain-containing protein CHCHD2P9, mitochondrial"	"CHCHD2"
"26S protease regulatory subunit 6A"	"PSMC3"
"Apoptotic chromatin condensation inducer in the nucleus"	"ACIN1"
"RNA-binding protein MEX3D"	"MEX3D"
